"Date","ReferenceNo.","Type","Description","Debit","Credit","CheckNumber","Balance"
"12/14/2023","","DEBIT","Withdrawal  @ LINDA'S TAQUERIA ME 0 LINDA'S TAQUERIA SACRAMENTO CA US","-14.51","","","62.79"
"12/14/2023","","DEBIT","Withdrawal  @ DALEK ONE* SUBSCR 1 0 DALEK ONE* SUBSC HTTPSDALEKONEMN US","-7","","","55.79"
"12/16/2023","","DEBIT","Withdrawal  @ BONFARE MARKET #33 0 BONFARE MARKET # SACRAMENTO CA US","-7.89","","","47.9"
"12/16/2023","","CREDIT","Checking Deposit Overdraft transfer from ****190-S0","","200","","247.9"
"12/16/2023","","DEBIT","Withdrawal ATM OVERDRAFT PROTECTION FEE","-2","","","245.9"
"12/16/2023","","DEBIT","Withdrawal  @ BONFARE MARKET #33 0 BONFARE MARKET # SACRAMENTO CA US","-11.17","","","234.73"
"12/16/2023","","DEBIT","Withdrawal  @ SPLICE.COM* SPLICE 0 SPLICE.COM* SPLI SPLICE.COM NY US","-9.99","","","224.74"
"12/16/2023","","DEBIT","Withdrawal  @ SQ *TEMPLE COFFEE 0 SQ *TEMPLE COFFE Sacramento CA US","-15.41","","","209.33"
"12/16/2023","","DEBIT","Withdrawal  @ SACRAMENTO NATURAL 0 SACRAMENTO NATUR SACRAMENTO CA US","-85.48","","","123.85"
"12/16/2023","","DEBIT","Withdrawal  @ CASH APP*TEMPLE COF 0 CASH APP*TEMPLE 800-9691940 CA US","-7.8","","","116.05"
"12/17/2023","","DEBIT","Withdrawal  @ LYFT RIDE SAT 1AM 0 LYFT RIDE SAT 855-865-9553 CA US","-14.79","","","101.26"
"12/17/2023","","DEBIT","Withdrawal  @ SQ *PACHAMAMA COFFE 0 SQ *PACHAMAMA CO Sacramento CA US","-13.62","","","87.64"
"12/17/2023","","DEBIT","Withdrawal  @ SOCAL'S TAVERN 0 SOCAL'S TAVERN SACRAMENTO CA US","-25.84","","","61.8"
"12/18/2023","","DEBIT","Withdrawal  @ CASH APP*TEMPLE COF 0 CASH APP*TEMPLE 800-9691940 CA US","-25.4","","","36.4"
"12/19/2023","","DEBIT","Withdrawal  @ SPOTIFY 0 SPOTIFY 877-778-1161 NY US","-10.99","","","25.41"
"12/19/2023","","DEBIT","Withdrawal  @ Prime Video Channel 0 Prime Video Chan amzn.com/billWA US","-11.99","","","13.42"
"12/19/2023","","CREDIT","Checking Deposit Overdraft transfer from ****190-S0","","200","","213.42"
"12/19/2023","","DEBIT","Withdrawal ATM OVERDRAFT PROTECTION FEE","-2","","","211.42"
"12/20/2023","","DEBIT","Withdrawal  @ LINDA'S TAQUERIA ME 0 LINDA'S TAQUERIA SACRAMENTO CA US","-15.78","","","195.64"
"12/20/2023","","DEBIT","Withdrawal-ACH-A-983291 WEBADVS ED SERV WEB (STUDNTLOAN)","-201.16","","","-5.52"
"12/20/2023","","CREDIT","Checking Deposit Overdraft transfer from ****190-S0","","123.73","","118.21"
"12/20/2023","","DEBIT","Withdrawal ACH SHARE TRANSFER FEE","-2","","","116.21"
"12/20/2023","","DEBIT","Withdrawal  @ VENMO* 0 VENMO* Visa Direct NY US","-30","","","86.21"
"12/20/2023","","CREDIT","Checking Deposit  @ VENMO*Del Fava Marc 0 VENMO*Del Fava M New York CityNY US","","22.6","","108.81"
"12/20/2023","","DEBIT","Withdrawal  @ APPLE.COM/BILL 0 APPLE.COM/BILL 866-712-7753 CA US","-7.99","","","100.82"
"12/20/2023","","DEBIT","Withdrawal  @ CASH APP*MICHAEL LE 0 CASH APP*MICHAEL 800-9691940 CA US","-20","","","80.82"
"12/21/2023","","DEBIT","Withdrawal  @ CASH APP*TEMPLE COF 0 CASH APP*TEMPLE 800-9691940 CA US","-9.92","","","70.9"
"12/22/2023","","DEBIT","Withdrawal  @ BEATPORT 0 BEATPORT 720-974-9500 CO US","-9.16","","","61.74"
"12/22/2023","","CREDIT","Checking Deposit Overdraft transfer from ****190-S0","","200","","261.74"
"12/22/2023","","DEBIT","Withdrawal ATM OVERDRAFT PROTECTION FEE","-2","","","259.74"
"12/22/2023","","DEBIT","Withdrawal  @ SACRAMENTO NATURAL 0 SACRAMENTO NATUR SACRAMENTO CA US","-1.2","","","258.54"
"12/22/2023","","DEBIT","Withdrawal  @ TST* THE FLAMINGO H 0 TST* THE FLAMING SACRAMENTO CA US","-18.65","","","239.89"
"12/22/2023","","DEBIT","Withdrawal  @ SQ *TEMPLE COFFEE? 0 SQ *TEMPLE COFFE Sacramento CA US","-26.65","","","213.24"
"12/22/2023","","DEBIT","Withdrawal  @ SAIGON CORNER 0 SAIGON CORNER SACRAMENTO CA US","-32.96","","","180.28"
"12/22/2023","","DEBIT","Withdrawal  @ SACRAMENTO NATURAL 0 SACRAMENTO NATUR SACRAMENTO CA US","-42.63","","","137.65"
"12/22/2023","","DEBIT","Withdrawal  @ APPLE.COM/BILL 0 APPLE.COM/BILL 866-712-7753 CA US","-12.99","","","124.66"
"12/23/2023","","DEBIT","Withdrawal  @ BANDCAMP TSURUDA 0 BANDCAMP TSURUDA San Jose CA US","-3","","","121.66"
"12/23/2023","","DEBIT","Withdrawal  @ BANDCAMP LUMASI 0 BANDCAMP LUMASI San Jose CA US","-1","","","120.66"
"12/23/2023","","DEBIT","Withdrawal  @ BANDCAMP VISIVE 0 BANDCAMP VISIVE San Jose CA US","-1","","","119.66"
"12/23/2023","","DEBIT","Withdrawal  @ NETFLIX COM 0 NETFLIX COM LOS GATOS CA US","-15.49","","","104.17"
"12/23/2023","","DEBIT","Withdrawal  @ BEATPORT 0 BEATPORT 720-974-9500 CO US","-50.79","","","53.38"
"12/24/2023","","DEBIT","Withdrawal  @ RAMEN 101 MIDTOWN 0 RAMEN 101 MIDTOW SACRAMENTO CA US","-61.93","","","-8.55"
"12/24/2023","","CREDIT","Checking Deposit Overdraft transfer from ****190-S0","","200","","191.45"
"12/24/2023","","DEBIT","Withdrawal ATM OVERDRAFT PROTECTION FEE","-2","","","189.45"
"12/24/2023","","DEBIT","Withdrawal  @ UNIVERSITY ART CENT 0 UNIVERSITY ART C SACRAMENTO CA US","-65.11","","","124.34"
"12/24/2023","","DEBIT","Withdrawal  @ 2838 J ST RE 1 0 ARCO#83191J STRE SACRAMENTO CA US","-44.1","","","80.24"
"12/24/2023","","CREDIT","Checking Deposit Overdraft transfer from ****190-S0","","200","","280.24"
"12/24/2023","","DEBIT","Withdrawal  @ BANDCAMP FWD 0 BANDCAMP FWD 402-935-7733 CA US","-1.27","","","278.97"
"12/24/2023","","DEBIT","Withdrawal  @ SQ *CHOCOLATE FISH 0 SQ *CHOCOLATE FI Sacramento CA US","-21.2","","","257.77"
"12/24/2023","","DEBIT","Withdrawal  @ FLOWCHART FUN PRO 0 FLOWCHART FUN PR HTTPSFLOWCHARNC US","-3","","","254.77"
"12/24/2023","","DEBIT","Withdrawal  @ SAIGON CORNER 0 SAIGON CORNER SACRAMENTO CA US","-15.57","","","239.2"
"12/25/2023","","DEBIT","Withdrawal  @ BONFARE MARKET #33 0 BONFARE MARKET # SACRAMENTO CA US","-8.38","","","230.82"
"12/25/2023","","DEBIT","Withdrawal  @ SAFEWAY #2242 0 SAFEWAY #2242 SACRAMENTO CA US","-75.32","","","155.5"
"12/26/2023","","DEBIT","Withdrawal  @ SAFEWAY #2684 0 SAFEWAY #2684 SACRAMENTO CA US","-49.9","","","105.6"
"12/27/2023","","CREDIT","Checking Deposit  @ G1 Online Transfer 'STD' 800.00 from share 0","","800","","905.6"
"12/27/2023","","DEBIT","Withdrawal  @ SQ *TEMPLE COFFEE? 0 SQ *TEMPLE COFFE Sacramento CA US","-5.62","","","899.98"
"12/28/2023","","DEBIT","Withdrawal  @ SOUND KINGDOM II: M 0 SOUND KINGDOM II WEST VANCOUVEBC CA","-3.03","","","896.95"
"12/28/2023","","CREDIT","ISA Single-Currency Fee Assessed = 0.03 on 3.00","","0","","0.0"
"12/28/2023","","DEBIT","Withdrawal  @ SOUND KINGDOM II: F 0 SOUND KINGDOM II WEST VANCOUVEBC CA","-5.05","","","891.9"
"12/28/2023","","CREDIT","ISA Single-Currency Fee Assessed = 0.05 on 5.00","","0","","0.0"
"12/28/2023","","DEBIT","Withdrawal  @ Prime Video Channel 0 Prime Video Chan amzn.com/billWA US","-0.99","","","890.91"
"12/28/2023","","DEBIT","Withdrawal-ACH-A-990166 WEBHomeRiver Group (WEB PMTS)","-755","","","135.91"
"12/29/2023","","DEBIT","Withdrawal-ACH-A-1096016 ATT (Payment)","-79.99","","","55.92"
"12/30/2023","","DEBIT","Withdrawal  @ ADALBERTO'S MEXICAN 0 ADALBERTO'S MEXI SACRAMENTO CA US","-15.16","","","40.76"
"12/31/2023","","DEBIT","Withdrawal  @ EMBRACE PET INSURAN 0 EMBRACE PET INSU HELLO@EMBRACEOH US","-17.89","","","22.87"
"12/31/2023","","CREDIT","Checking Deposit  @ VENMO*Del Fava Marc 0 VENMO*Del Fava M New York CityNY US","","89.41","","112.28"
"12/31/2023","","DEBIT","Withdrawal  @ SACRAMENTO NATURAL 0 SACRAMENTO NATUR SACRAMENTO CA US","-85.88","","","26.4"
"1/1/2024","","DEBIT","Withdrawal  @ MICHAELS STORES 512 0 MICHAELS STORES SACRAMENTO CA US","-10.21","","","16.19"
"1/1/2024","","DEBIT","Withdrawal  @ GOOGLE*GSUITE BARKB 0 GOOGLE*GSUITE BA CC GOOGLE.COMCA US","-14.4","","","1.79"
"1/5/2024","","DEBIT","Withdrawal-ACH-A-861479 GEICO (PREM COLL)","-53.28","","","-51.49"
"1/5/2024","","CREDIT","Checking Deposit Overdraft transfer from ****190-S0","","0.03","","-51.46"
"1/5/2024","","DEBIT","Withdrawal COURTESY PAY FEE 20.00","-20","","","-71.46"
"1/5/2024","","CREDIT","A Courtesy Payment was made for the amount of 51.46.","","0","","0.0"
"1/5/2024","","CREDIT","Checking Deposit  @ G1 Online Transfer 'STD' 200.00 from share 0","","200","","128.54"
"1/6/2024","","DEBIT","Withdrawal  @ SQ *TEMPLE COFFEE 0 SQ *TEMPLE COFFE Sacramento CA US","-11.79","","","116.75"
"1/6/2024","","DEBIT","Withdrawal  @ APPLE.COM/BILL 0 APPLE.COM/BILL 866-712-7753 CA US","-2.99","","","113.76"
"1/6/2024","","DEBIT","Withdrawal  @ SACRAMENTO NATURAL 0 SACRAMENTO NATUR SACRAMENTO CA US","-195.38","","","-81.62"
"1/6/2024","","CREDIT","Checking Deposit Overdraft transfer from ****190-S0","","200","","118.38"
"1/6/2024","","DEBIT","Withdrawal  @ CSI-210982/2216 0 CSI-210982/2216 SACRAMENTO CA US","-20","","","98.38"
"1/6/2024","","CREDIT","Checking Deposit Overdraft transfer from ****190-S0","","200","","298.38"
"1/7/2024","","DEBIT","Withdrawal  @ Dr Martens Airwair 0 Dr Martens Airwa PORTLAND OR US","-106.68","","","191.7"
"1/7/2024","","DEBIT","Withdrawal  @ SOUNDCLOUD INC 0 SOUNDCLOUD INC 176-3257837 NY US","-16","","","175.7"
"1/7/2024","","DEBIT","Withdrawal  @ SAFEWAY #2242 0 SAFEWAY #2242 SACRAMENTO CA US","-78.87","","","96.83"
"1/7/2024","","DEBIT","Withdrawal  @ MELS MOCHA AND ICE 0 MELS MOCHA AND I WALNUT GROVE CA US","-3.6","","","93.23"
"1/7/2024","","DEBIT","Withdrawal  @ TARGET 00033 0 TARGET 00 SACRAMENTO CA US","-6.51","","","86.72"
"1/8/2024","","CREDIT","Checking Deposit  @ G1 Online Transfer 'STD' 60.00 from share 0","","60","","146.72"
"1/9/2024","","DEBIT","Withdrawal  @ La Popular Supermar 0 La Popular Super SACRAMENTO CA US","-16.62","","","130.1"
"1/10/2024","","DEBIT","Withdrawal  @ SACRAMENTO PIPEWORK 0 SACRAMENTO PIPEW WWW.TOUCHSTONCA US","-89","","","41.1"
"1/11/2024","","DEBIT","Withdrawal  @ BONFARE MARKET #33 0 BONFARE MARKET # SACRAMENTO CA US","-7.71","","","33.39"
"1/11/2024","","DEBIT","Withdrawal  @ SQ *TEMPLE COFFEE 0 SQ *TEMPLE COFFE Sacramento CA US","-12.02","","","21.37"
"1/11/2024","","DEBIT","Withdrawal  @ O'REILLY 2593 0 O'REILLY 2593 SACRAMENTO CA US","-38.74","","","-17.37"
"1/11/2024","","CREDIT","Checking Deposit Overdraft transfer from ****190-S0","","200","","182.63"
"1/11/2024","","DEBIT","Withdrawal  @ SACRAMENTO NATURAL 0 SACRAMENTO NATUR SACRAMENTO CA US","-70","","","112.63"
"1/12/2024","","DEBIT","Withdrawal  @ SHELL SERVICE STATI 0 SHELL SERVICE ST SACRAMENTO CA US","-57.45","","","55.18"
"1/12/2024","","DEBIT","Withdrawal  @ I LOVE TERIYAKI 0 I LOVE TERIYAKI SACRAMENTO CA US","-16.14","","","39.04"
"1/13/2024","","DEBIT","Withdrawal  @ TST* CAFE COLONIAL 0 TST* CAFE COLONI Sacramento CA US","-21","","","18.04"
"1/13/2024","","CREDIT","Checking Deposit Overdraft transfer from ****190-S0","","200","","218.04"
"1/13/2024","","DEBIT","Withdrawal  @ SQ *TEMPLE COFFEE 0 SQ *TEMPLE COFFE Sacramento CA US","-13.68","","","204.36"
"1/13/2024","","DEBIT","Withdrawal  @ JACK IN THE BOX 430 0 JACK IN THE BOX SACRAMENTO CA US","-11.61","","","192.75"
"1/14/2024","","DEBIT","Withdrawal  @ PETCO 1343 0 PETCO 1343 SACRAMENTO CA US","-105.42","","","87.33"
"1/14/2024","","DEBIT","Withdrawal  @ DALEK ONE* SUBSCR 1 0 DALEK ONE* SUBSC HTTPSDALEKONEMN US","-7","","","80.33"
"1/14/2024","","DEBIT","Withdrawal  @ SACRAMENTO NATURAL 0 SACRAMENTO NATUR SACRAMENTO CA US","-64.9","","","15.43"
"1/15/2024","","DEBIT","Withdrawal  @ SACRAMENTO NATURAL 0 SACRAMENTO NATUR SACRAMENTO CA US","-81.34","","","-65.91"
"1/15/2024","","CREDIT","Checking Deposit Overdraft transfer from ****190-S0","","200","","134.09"
"1/16/2024","","DEBIT","Withdrawal  @ SPLICE.COM* SPLICE 0 SPLICE.COM* SPLI SPLICE.COM NY US","-9.99","","","124.1"
"1/17/2024","","DEBIT","Withdrawal  @ BONFARE MARKET #33 0 BONFARE MARKET # SACRAMENTO CA US","-8.38","","","115.72"
"1/18/2024","","DEBIT","Withdrawal  @ ATMGO864654 2820 R STREET CSSI0 GOLDEN 1 CU SACRAMENTO CA US","-80","","","35.72"
"1/19/2024","","DEBIT","Withdrawal  @ SPOTIFY 0 SPOTIFY 877-778-1161 NY US","-10.99","","","24.73"
"1/19/2024","","DEBIT","Withdrawal  @ Prime Video Channel 0 Prime Video Chan amzn.com/billWA US","-11.99","","","12.74"
"1/20/2024","","CREDIT","Checking Deposit  @ G1 Online Transfer 'STD' 500.00 from share 0","","500","","512.74"
"1/20/2024","","DEBIT","Withdrawal  @ VENMO* 0 VENMO* Visa Direct NY US","-60","","","452.74"
"1/20/2024","","DEBIT","Withdrawal  @ VENMO* 0 VENMO* Visa Direct NY US","-60","","","392.74"
"1/21/2024","","DEBIT","Withdrawal  @ CAPITOL BOWL 0 CAPITOL BOWL WEST SACRAMENCA US","-24.07","","","368.67"
"1/21/2024","","DEBIT","Withdrawal  @ CAPITOL BOWL 0 CAPITOL BOWL WEST SACRAMENCA US","-9","","","359.67"
"1/21/2024","","DEBIT","Withdrawal  @ CITYOFSAC-PARKINGWE 0 CITYOFSAC-PARKIN 916-808-5110 CA US","-107.5","","","252.17"
"1/21/2024","","DEBIT","Withdrawal  @ AUTOZONE 5593 1900 0 AUTOZONE 5593 1 SACRAMENTO CA US","-30.44","","","221.73"
"1/21/2024","","DEBIT","Withdrawal  @ KUPROS CRAFT HOUSE 0 KUPROS CRAFT HOU SACRAMENTO CA US","-6.2","","","215.53"
"1/22/2024","","DEBIT","Withdrawal  @ LOVE LAUNDRY 0 LOVE LAUNDRY SACRAMENTO CA US","-15","","","200.53"
"1/22/2024","","DEBIT","Withdrawal  @ LOVE LAUNDRY 0 LOVE LAUNDRY SACRAMENTO CA US","-9.85","","","190.68"
"1/22/2024","","DEBIT","Withdrawal  @ AZUL MEXICAN FOOD & 0 AZUL MEXICAN FOO SACRAMENTO CA US","-30.4","","","160.28"
"1/22/2024","","DEBIT","Withdrawal  @ APPLE.COM/BILL 0 APPLE.COM/BILL 866-712-7753 CA US","-12.99","","","147.29"
"1/22/2024","","DEBIT","Withdrawal  @ AMZN Mktp US*R81K97 0 AMZN Mktp US*R81 Amzn.com/billWA US","-26.07","","","121.22"
"1/23/2024","","DEBIT","Withdrawal  @ NETFLIX COM 0 NETFLIX COM LOS GATOS CA US","-15.49","","","105.73"
"1/23/2024","","DEBIT","Withdrawal  @ SQ *TEMPLE COFFEE? 0 SQ *TEMPLE COFFE Sacramento CA US","-6.9","","","98.83"
"1/23/2024","","DEBIT","Withdrawal  @ LYFT RIDE TUE 12P 0 LYFT RIDE TUE 855-865-9553 CA US","-24.99","","","73.84"
"1/23/2024","","DEBIT","Withdrawal  @ 809 20TH ST 0 BONFARE MARKET # SACRAMENTO CA US","-21.19","","","52.65"
"1/24/2024","","DEBIT","Withdrawal  @ FLOWCHART FUN PRO 0 FLOWCHART FUN PR HTTPSFLOWCHARNC US","-3","","","49.65"
"1/24/2024","","DEBIT","Withdrawal  @ SAFEWAY #2242 0 SAFEWAY #2242 SACRAMENTO CA US","-23.54","","","26.11"
"1/25/2024","","DEBIT","Withdrawal  @ Prime Video *R01X47 0 Prime Video *R01 888-802-3080 WA US","-3.99","","","22.12"
"1/25/2024","","DEBIT","Withdrawal  @ KAISER PHARM 02971 0 KAISER PHARM 029 SACRAMENTO CA US","-15","","","7.12"
"1/25/2024","","DEBIT","Withdrawal  @ SQ *TEMPLE COFFEE 0 SQ *TEMPLE COFFE Sacramento CA US","-22.45","","","-15.33"
"1/25/2024","","CREDIT","Checking Deposit Overdraft transfer from ****190-S0","","200","","184.67"
"1/26/2024","","DEBIT","Withdrawal  @ AUTOZONE 5593 1900 0 AUTOZONE 5593 1 SACRAMENTO CA US","-72.83","","","111.84"
"1/28/2024","","DEBIT","Withdrawal  @ CASH APP*NEIL ANDRA 0 CASH APP*NEIL AN 800-9691940 CA US","-10","","","101.84"
"1/28/2024","","CREDIT","Checking Deposit  @ G1 Online Transfer 'STD' 400.00 from share 0","","400","","501.84"
"1/28/2024","","DEBIT","Withdrawal  @ SQ *ON THE Y 0 SQ *ON THE Y Sacramento CA US","-36.56","","","465.28"
"1/28/2024","","DEBIT","Withdrawal  @ CVS/PHARMACY #09 09 0 CVS/PHARMACY #09 Campbell CA US","-21.86","","","443.42"
"1/28/2024","","CREDIT","Checking Deposit Overdraft transfer from ****190-S0","","200","","643.42"
"1/28/2024","","DEBIT","Withdrawal  @ Prime Video Channel 0 Prime Video Chan amzn.com/billWA US","-0.99","","","642.43"
"1/28/2024","","DEBIT","Withdrawal  @ ENTERPRISE RENT-A-C 0 ENTERPRISE RENT- SACRAMENTO CA US","-417.99","","","224.44"
"1/29/2024","","DEBIT","Withdrawal  @ APPLE CASH SENT MON 0 APPLE CASH SENT 1INFINITELOOPCA US","-20","","","204.44"
"1/30/2024","","DEBIT","Withdrawal-ACH-A-1096016 ATT (Payment)","-79.99","","","124.45"
"1/30/2024","","DEBIT","Withdrawal  @ SACRAMENTO NATURAL 0 SACRAMENTO NATUR SACRAMENTO CA US","-73","","","51.45"
"1/30/2024","","CREDIT","Checking Deposit  @ ENTERPRISE RENT-A-C 0 ENTERPRISE RENT- SACRAMENTO CA US","","300","","351.45"
"1/31/2024","","DEBIT","Withdrawal  @ EMBRACE PET INSURAN 0 EMBRACE PET INSU HELLO@EMBRACEOH US","-17.89","","","333.56"
"1/31/2024","","DEBIT","Withdrawal  @ CVS/PHARMACY #04 04 0 CVS/PHARMACY #04 Rancho CordovCA US","-2.09","","","331.47"
"1/31/2024","","CREDIT","Checking Deposit  @ G1 Online Transfer 'STD' 241.00 from share 0","","241","","572.47"
"1/31/2024","","CREDIT","Checking Deposit  @ G1 Online Transfer 169.00 from LV 1","","169","","741.47"
"2/1/2024","","DEBIT","Withdrawal  @ GOOGLE *GSUITE bark 0 GOOGLE *GSUITE b cc@google.comCA US","-14.4","","","727.07"
"2/1/2024","","DEBIT","Withdrawal  @ SOUNDCLOUD INC 0 SOUNDCLOUD INC 176-3257837 NY US","-16","","","711.07"
"2/2/2024","","DEBIT","Withdrawal  @ APPLE.COM/BILL 0 APPLE.COM/BILL 866-712-7753 CA US","-2.99","","","708.08"
"2/2/2024","","DEBIT","Withdrawal-ACH-A-990166 WEBHomeRiver Group (WEB PMTS)","-700","","","8.08"
"2/5/2024","","DEBIT","Withdrawal-ACH-A-861479 GEICO (PREM COLL)","-53.09","","","-45.01"
"2/5/2024","","CREDIT","Checking Deposit Overdraft transfer from ****190-S0","","0.74","","-44.27"
"2/5/2024","","DEBIT","Withdrawal COURTESY PAY FEE 20.00","-20","","","-64.27"
"2/5/2024","","CREDIT","A Courtesy Payment was made for the amount of 44.27.","","0","","0.0"
"2/6/2024","","CREDIT","Checking Deposit  @ G1 Online Transfer 'STD' 200.00 from share 0","","200","","135.73"
"2/7/2024","","DEBIT","Withdrawal  @ 809 20TH ST 0 BONFARE MARKET # SACRAMENTO CA US","-47.24","","","88.49"
"2/7/2024","","DEBIT","Withdrawal  @ SQ *TEMPLE COFFEE 0 SQ *TEMPLE COFFE Sacramento CA US","-16.25","","","72.24"
"2/7/2024","","CREDIT","Checking Deposit  @ G1 Online Transfer 'STD' 200.00 from share 0","","200","","272.24"
"2/7/2024","","DEBIT","Withdrawal  @ SACRAMENTO NATURAL 0 SACRAMENTO NATUR SACRAMENTO CA US","-279","","","-6.76"
"2/7/2024","","CREDIT","Checking Deposit Overdraft transfer from ****190-S0","","200","","193.24"
"2/8/2024","","DEBIT","Withdrawal  @ LA POPULAR SUPERMAR 0 LA POPULAR SUPER SACRAMENTO CA US","-13.79","","","179.45"
"2/8/2024","","DEBIT","Withdrawal-ACH-A-990166 WEBHomeRiver Group (WEB PMTS)","-55","","","124.45"
"2/8/2024","","DEBIT","Withdrawal  @ AMZN Mktp US*R25DN1 0 AMZN Mktp US*R25 Amzn.com/billWA US","-17.17","","","107.28"
"2/8/2024","","DEBIT","Withdrawal  @ 809 20TH ST 0 BONFARE MARKET # SACRAMENTO CA US","-15","","","92.28"
"2/9/2024","","DEBIT","Withdrawal  @ ERAC TOLL 37Q811 0 ERAC TOLL 37Q811 877-860-1258 CA US","-11.95","","","80.33"
"2/9/2024","","DEBIT","Withdrawal-ACH-A-1064712 WEBSMUD (WEB PAY)","-185.27","","","-104.94"
"2/9/2024","","CREDIT","Checking Deposit Overdraft transfer from ****190-S0","","200","","95.06"
"2/9/2024","","DEBIT","Withdrawal  @ 3539 BRADSHAW ROAD 0 FALAFEL CORNER SACRAMENTO CA US","-14.83","","","80.23"
"2/9/2024","","DEBIT","Withdrawal  @ Coyni 877 371 6122 0 Coyni 877 371 61 Miami FL US","-22.32","","","57.91"
"2/9/2024","","DEBIT","Withdrawal  @ Coyni 877 371 6122 0 Coyni 877 371 61 Miami FL US","-31.78","","","26.13"
"2/9/2024","","DEBIT","Withdrawal  @ AMAZON.COM*RB6UF4QG 0 AMAZON.COM*RB6UF SEATTLE WA US","-3.62","","","22.51"
"2/10/2024","","DEBIT","Withdrawal  @ STARBUCKS STORE 058 0 STARBUCKS STORE SACRAMENTO CA US","-5.25","","","17.26"
"2/11/2024","","DEBIT","Withdrawal  @ Prime Video *RI5QO8 0 Prime Video *RI5 888-802-3080 WA US","-5.99","","","11.27"
"2/11/2024","","CREDIT","Checking Deposit Overdraft transfer from ****190-S0","","200","","211.27"
"2/11/2024","","DEBIT","Withdrawal  @ TST* EL RINCON MEXI 0 TST* EL RINCON M SACRAMENTO CA US","-31.9","","","179.37"
"2/11/2024","","DEBIT","Withdrawal  @ SACRAMENTO NATURAL 0 SACRAMENTO NATUR SACRAMENTO CA US","-94.99","","","84.38"
"2/11/2024","","DEBIT","Withdrawal  @ SOCAL'S TAVERN 0 SOCAL'S TAVERN SACRAMENTO CA US","-8.61","","","75.77"
"2/12/2024","","DEBIT","Withdrawal  @ LOVE LAUNDRY 0 LOVE LAUNDRY SACRAMENTO CA US","-7.5","","","68.27"
"2/12/2024","","DEBIT","Withdrawal  @ LOVE LAUNDRY 0 LOVE LAUNDRY SACRAMENTO CA US","-11.33","","","56.94"
"2/12/2024","","DEBIT","Withdrawal-ACH-A-983291 WEBADVS ED SERV WEB (STUDNTLOAN)","-151.08","","","-94.14"
"2/12/2024","","CREDIT","Checking Deposit Overdraft transfer from ****190-S0","","200","","105.86"
"2/12/2024","","DEBIT","Withdrawal  @ ORBIT WASH 0 ORBIT WASH SACRAMENTO CA US","-12.5","","","93.36"
"2/13/2024","","DEBIT","Withdrawal  @ VENMO *Ana Rodrigu 0 VENMO *Ana Rodr Visa Direct NY US","-35","","","58.36"
"2/14/2024","","DEBIT","Withdrawal  @ AMZN Mktp US*RB8DU1 0 AMZN Mktp US*RB8 Amzn.com/billWA US","-36.87","","","21.49"
"2/14/2024","","DEBIT","Withdrawal  @ CA DMV FEE 0 CA DMV FEE 678-7315516 TN US","-0.04","","","21.45"
"2/14/2024","","DEBIT","Withdrawal  @ STATE OF CALIF DMV 0 STATE OF CALIF D 800-7770133 CA US","-2","","","19.45"
"2/14/2024","","DEBIT","Withdrawal  @ Coyni 877 371 6122 0 Coyni 877 371 61 Miami FL US","-16.66","","","2.79"
"2/14/2024","","CREDIT","Checking Deposit  @ G1 Online Transfer 'STD' 50.00 from share 0","","50","","52.79"
"2/14/2024","","DEBIT","Withdrawal  @ DALEK ONE* SUBSCR 1 0 DALEK ONE* SUBSC HTTPSDALEKONEMN US","-7","","","45.79"
"2/14/2024","","DEBIT","Withdrawal  @ Prime Video *RB6L99 0 Prime Video *RB6 888-802-3080 WA US","-5.99","","","39.8"
"2/15/2024","","DEBIT","Withdrawal  @ 809 20TH ST 0 BONFARE MARKET # SACRAMENTO CA US","-4.99","","","34.81"
"2/15/2024","","DEBIT","Withdrawal  @ SAFEWAY #2242 0 SAFEWAY #2242 SACRAMENTO CA US","-62.95","","","-28.14"
"2/15/2024","","CREDIT","Checking Deposit Overdraft transfer from ****190-S0","","200","","171.86"
"2/15/2024","","DEBIT","Withdrawal  @ SAIGON CORNER 0 SAIGON CORNER SACRAMENTO CA US","-13.12","","","158.74"
"2/15/2024","","DEBIT","Withdrawal  @ SPLICE.COM* CREDITB 0 SPLICE.COM* CRED SPLICE.COM NY US","-4.99","","","153.75"
"2/15/2024","","DEBIT","Withdrawal  @ SPLICE.COM* CREDITB 0 SPLICE.COM* CRED SPLICE.COM NY US","-4.99","","","148.76"
"2/16/2024","","DEBIT","Withdrawal  @ TST* THE FLAMINGO H 0 TST* THE FLAMING SACRAMENTO CA US","-18.94","","","129.82"
"2/16/2024","","DEBIT","Withdrawal  @ SPLICE.COM* SPLICE 0 SPLICE.COM* SPLI SPLICE.COM NY US","-9.99","","","119.83"
"2/17/2024","","DEBIT","Withdrawal  @ SQ *TEMPLE COFFEE 0 SQ *TEMPLE COFFE Sacramento CA US","-27.8","","","92.03"
"2/17/2024","","DEBIT","Withdrawal  @ SQ *ZENA FOODS & SP 0 SQ *ZENA FOODS & SACRAMENTO CA US","-9","","","83.03"
"2/18/2024","","DEBIT","Withdrawal  @ SAFEWAY #2242 0 SAFEWAY #2242 SACRAMENTO CA US","-67.94","","","15.09"
"2/19/2024","","CREDIT","Checking Deposit  @ G1 Online Transfer 'STD' 50.00 from share 0","","50","","65.09"
"2/19/2024","","DEBIT","Withdrawal  @ SPOTIFY 0 SPOTIFY 877-778-1161 NY US","-10.99","","","54.1"
"2/19/2024","","DEBIT","Withdrawal  @ G1 Online Transfer 'DTS' 50.00 to share 0","-50","","","4.1"
"2/19/2024","","CREDIT","Checking Deposit  @ G1 Online Transfer 'STD' 50.00 from share 0","","50","","54.1"
"2/19/2024","","CREDIT","Checking Deposit  @ G1 Online Transfer 'STD' 44.00 from share 0","","44","","98.1"
"2/19/2024","","DEBIT","Withdrawal  @ Prime Video Channel 0 Prime Video Chan amzn.com/billWA US","-11.99","","","86.11"
"2/19/2024","","CREDIT","Checking Deposit  @ G1 Online Transfer 22.00 from LV 1","","22","","108.11"
"2/19/2024","","DEBIT","Withdrawal  @ SAFEWAY #2242 0 SAFEWAY #2242 SACRAMENTO CA US","-26.55","","","81.56"
"2/20/2024","","CREDIT","Checking Deposit  @ Prime Video Channel 0 Prime Video Chan amzn.com/billWA US","","11.99","","93.55"
"2/20/2024","","DEBIT","Withdrawal  @ Coyni 877 371 6122 0 Coyni 877 371 61 Miami FL US","-67.75","","","25.8"
"2/21/2024","","DEBIT","Withdrawal  @ STARBUCKS STORE 058 0 STARBUCKS STORE SACRAMENTO CA US","-11.2","","","14.6"
"2/22/2024","","DEBIT","Withdrawal  @ LINDA'S TAQUERIA ME 0 LINDA'S TAQUERIA SACRAMENTO CA US","-20.53","","","-5.93"
"2/22/2024","","CREDIT","Checking Deposit Overdraft transfer from ****190-S0","","200","","194.07"
"2/23/2024","","DEBIT","Withdrawal  @ BONFARE MARKET #33 0 BONFARE MARKET # SACRAMENTO CA US","-17.5","","","176.57"
"2/23/2024","","DEBIT","Withdrawal  @ NETFLIX COM 0 NETFLIX COM LOS GATOS CA US","-15.49","","","161.08"
"2/23/2024","","DEBIT","Withdrawal  @ SQ *TEMPLE COFFEE 0 SQ *TEMPLE COFFE Sacramento CA US","-16.68","","","144.4"
"2/23/2024","","DEBIT","Withdrawal  @ 809 20TH ST 0 BONFARE MARKET # SACRAMENTO CA US","-25.99","","","118.41"
"2/24/2024","","DEBIT","Withdrawal  @ SQ *PUSHKIN'S BAKER 0 SQ *PUSHKIN'S BA Sacramento CA US","-16.56","","","101.85"
"2/24/2024","","DEBIT","Withdrawal  @ FLOWCHART FUN PRO 0 FLOWCHART FUN PR HTTPSFLOWCHARNC US","-3","","","98.85"
"2/24/2024","","DEBIT","Withdrawal  @ EB JORDNMOODY AMP C 0 EB JORDNMOODY AM 8014137200 CA US","-21.25","","","77.6"
"2/25/2024","","DEBIT","Withdrawal  @ LOVE LAUNDRY 0 LOVE LAUNDRY SACRAMENTO CA US","-7","","","70.6"
"2/25/2024","","DEBIT","Withdrawal  @ SQ *ON THE Y 0 SQ *ON THE Y Sacramento CA US","-30.68","","","39.92"
"2/25/2024","","CREDIT","Checking Deposit Overdraft transfer from ****190-S0","","200","","239.92"
"2/25/2024","","DEBIT","Withdrawal  @ SQ *ON THE Y 0 SQ *ON THE Y Sacramento CA US","-8.85","","","231.07"
"2/25/2024","","DEBIT","Withdrawal  @ SQ *ON THE Y 0 SQ *ON THE Y Sacramento CA US","-8.55","","","222.52"
"2/25/2024","","DEBIT","Withdrawal  @ SQ *ON THE Y 0 SQ *ON THE Y Sacramento CA US","-8.55","","","213.97"
"2/25/2024","","DEBIT","Withdrawal  @ AMZN Mktp US*RZ9VO6 0 AMZN Mktp US*RZ9 Amzn.com/billWA US","-31.84","","","182.13"
"2/25/2024","","DEBIT","Withdrawal  @ AMZN Mktp US*RZ7VA6 0 AMZN Mktp US*RZ7 Amzn.com/billWA US","-16.63","","","165.5"
"2/25/2024","","DEBIT","Withdrawal  @ CORTI BROTHERS 0 CORTI BROTHERS SACRAMENTO CA US","-31.8","","","133.7"
"2/26/2024","","DEBIT","Withdrawal  @ DD *DOORDASH MINGDY 0 DD *DOORDASH MIN WWW.DOORDASH.CA US","-40.17","","","93.53"
"2/26/2024","","DEBIT","Withdrawal  @ APPLE.COM/BILL 0 APPLE.COM/BILL 866-712-7753 CA US","-12.99","","","80.54"
"2/26/2024","","DEBIT","Withdrawal  @ SACRAMENTO NATURAL 0 SACRAMENTO NATUR SACRAMENTO CA US","-71.32","","","9.22"
"2/27/2024","","DEBIT","Withdrawal  @ 809 20TH ST 0 BONFARE MARKET # SACRAMENTO CA US","-27.18","","","-17.96"
"2/27/2024","","CREDIT","Checking Deposit Overdraft transfer from ****190-S0","","200","","182.04"
"2/28/2024","","DEBIT","Withdrawal  @ Prime Video *RW15W4 0 Prime Video *RW1 888-802-3080 WA US","-3.99","","","178.05"
"2/28/2024","","DEBIT","Withdrawal-ACH-A-990166 WEBHomeRiver Group (WEB PMTS)","-755","","","-576.95"
"2/28/2024","","CREDIT","Checking Deposit Overdraft transfer from ****190-S0","","800","","223.05"
"2/28/2024","","DEBIT","Withdrawal  @ Coyni 877 371 6122 0 Coyni 877 371 61 Miami FL US","-51.79","","","171.26"
"2/28/2024","","DEBIT","Withdrawal  @ SQ *TEMPLE COFFEE 0 SQ *TEMPLE COFFE Sacramento CA US","-22.2","","","149.06"
"2/28/2024","","DEBIT","Withdrawal  @ SQ *BABES ICE CREAM 0 SQ *BABES ICE CR Sacramento CA US","-6.26","","","142.8"
"2/29/2024","","DEBIT","Withdrawal  @ BONFARE MARKET #33 0 BONFARE MARKET # SACRAMENTO CA US","-7.71","","","135.09"
"2/29/2024","","DEBIT","Withdrawal-ACH-A-1096016 ATT (Payment)","-79.99","","","55.1"
"2/29/2024","","DEBIT","Withdrawal  @ SQ *TEMPLE COFFEE 0 SQ *TEMPLE COFFE Sacramento CA US","-5.25","","","49.85"
"2/29/2024","","DEBIT","Withdrawal  @ META - PPGF 0 META - PPGF 4029357733 DC US","-5","","","44.85"
"3/1/2024","","DEBIT","Withdrawal  @ BONFARE MARKET #33 0 BONFARE MARKET # SACRAMENTO CA US","-7.71","","","37.14"
"3/1/2024","","DEBIT","Withdrawal  @ EMBRACE PET INSURAN 0 EMBRACE PET INSU HELLO@EMBRACEOH US","-17.89","","","19.25"
"3/1/2024","","DEBIT","Withdrawal  @ SOUNDCLOUD INC 0 SOUNDCLOUD INC 176-3257837 NY US","-16","","","3.25"
"3/1/2024","","CREDIT","Checking Deposit Overdraft transfer from ****190-S0","","178.44","","181.69"
"3/1/2024","","DEBIT","Withdrawal  @ APPLE.COM/BILL 0 APPLE.COM/BILL 866-712-7753 CA US","-2.99","","","178.7"
"3/1/2024","","DEBIT","Withdrawal  @ GOOGLE*GSUITE BARKB 0 GOOGLE*GSUITE BA CC GOOGLE.COMCA US","-14.4","","","164.3"
"3/1/2024","","DEBIT","Withdrawal  @ VENMO* Marc 0 VENMO* Marc Visa Direct NY US","-140","","","24.3"
"3/2/2024","","DEBIT","Withdrawal  @ DOLLARTREE 0 DOLLARTREE SACRAMENTO CA US","-1.35","","","22.95"
"3/4/2024","","DEBIT","Withdrawal  @ I LOVE TERIYAKI 0 I LOVE TERIYAKI SACRAMENTO CA US","-14","","","8.95"
"3/5/2024","","DEBIT","Withdrawal-ACH-A-861479 GEICO (PREM COLL)","-52.24","","","-43.29"
"3/5/2024","","DEBIT","Withdrawal COURTESY PAY FEE 20.00","-20","","","-63.29"
"3/5/2024","","CREDIT","A Courtesy Payment was made for the amount of 43.29.","","0","","0.0"
"3/7/2024","","CREDIT","Checking Deposit  @ G1 Online Transfer 'STD' 200.00 from share 0","","200","","136.71"
"3/7/2024","","DEBIT","Withdrawal  @ ATMP619467 411 N. 16TH STREET CSSI0 CAPITOL -619 SACRAMENTO CA US","-102","","","34.71"
"3/7/2024","","DEBIT","Withdrawal  @ SACRAMENTO NATURAL 0 SACRAMENTO NATUR SACRAMENTO CA US","-156","","","-121.29"
"3/7/2024","","CREDIT","Checking Deposit Overdraft transfer from ****190-S0","","200","","78.71"
"3/7/2024","","DEBIT","Withdrawal  @ 809 20TH ST 0 BONFARE MARKET # SACRAMENTO CA US","-12.28","","","66.43"
"3/7/2024","","DEBIT","Withdrawal ATM:Fee: ATM FEE DRAFT WITHDRAWAL Trace #9596","-2","","","64.43"
"3/7/2024","","CREDIT","ATM FEE DRAFT WITHDRAWAL Trace #9596 1 @ $2.00","","0","","0.0"
"3/8/2024","","DEBIT","Withdrawal  @ SAIGON CORNER 0 SAIGON CORNER SACRAMENTO CA US","-15.57","","","48.86"
"3/8/2024","","CREDIT","Checking Deposit Overdraft transfer from ****190-S0","","200","","248.86"
"3/9/2024","","DEBIT","Withdrawal  @ BONFARE MARKET #33 0 BONFARE MARKET # SACRAMENTO CA US","-4.99","","","243.87"
"3/10/2024","","DEBIT","Withdrawal  @ ZZOUNDS.COM 0 ZZOUNDS.COM 800-493-3945 NJ US","-49.75","","","194.12"
"3/10/2024","","DEBIT","Withdrawal  @ PETCO 1343 0 PETCO 1343 SACRAMENTO CA US","-21.48","","","172.64"
"3/10/2024","","DEBIT","Withdrawal  @ 03943--5039 Folsom 0 CVS/PHARMACY #03 Sacramento CA US","-12.42","","","160.22"
"3/10/2024","","DEBIT","Withdrawal  @ SACRAMENTO NATURAL 0 SACRAMENTO NATUR SACRAMENTO CA US","-56.03","","","104.19"
"3/11/2024","","DEBIT","Withdrawal  @ ORBIT WASH 0 ORBIT WASH SACRAMENTO CA US","-11.5","","","92.69"
"3/12/2024","","DEBIT","Withdrawal  @ BONFARE MARKET #33 0 BONFARE MARKET # SACRAMENTO CA US","-4.99","","","87.7"
"3/12/2024","","DEBIT","Withdrawal  @ APPLE CASH SENT MON 0 APPLE CASH SENT 1INFINITELOOPCA US","-30","","","57.7"
"3/12/2024","","DEBIT","Withdrawal  @ 5810 FOLSOM BLVD 0 CORTI BROTHERS SACRAMENTO CA US","-67.73","","","-10.03"
"3/12/2024","","CREDIT","Checking Deposit Overdraft transfer from ****190-S0","","200","","189.97"
"3/12/2024","","DEBIT","Withdrawal  @ 5810 FOLSOM BLVD 0 CORTI BROTHERS SACRAMENTO CA US","-3.49","","","186.48"
"3/12/2024","","DEBIT","Withdrawal  @ CHEVRON 0095632 0 CHEVRON 0095632 SACRAMENTO CA US","-62.24","","","124.24"
"3/14/2024","","DEBIT","Withdrawal  @ BONFARE MARKET #33 0 BONFARE MARKET # SACRAMENTO CA US","-4.99","","","119.25"
"3/14/2024","","DEBIT","Withdrawal  @ DALEK ONE* SUBSCR 1 0 DALEK ONE* SUBSC HTTPSDALEKONEMN US","-7","","","112.25"
"3/15/2024","","DEBIT","Withdrawal  @ BONFARE MARKET #33 0 BONFARE MARKET # SACRAMENTO CA US","-4.99","","","107.26"
"3/16/2024","","DEBIT","Withdrawal  @ SPLICE.COM* SPLICE 0 SPLICE.COM* SPLI SPLICE.COM NY US","-9.99","","","97.27"
"3/16/2024","","DEBIT","Withdrawal  @ SACRAMENTO NATURAL 0 SACRAMENTO NATUR SACRAMENTO CA US","-69.43","","","27.84"
"3/16/2024","","CREDIT","Checking Deposit Overdraft transfer from ****190-S0","","200","","227.84"
"3/17/2024","","DEBIT","Withdrawal  @ EB BLACK CARL-MOVE 0 EB BLACK CARL-MO 8014137200 CA US","-28.52","","","199.32"
"3/17/2024","","DEBIT","Withdrawal  @ SQ *FOREST FLOOR FA 0 SQ *FOREST FLOOR Sacramento CA US","-10","","","189.32"
"3/18/2024","","DEBIT","Withdrawal  @ CENTURY THEATRES 44 0 CENTURY THEATRES SACRAMENTO CA US","-14.25","","","175.07"
"3/18/2024","","DEBIT","Withdrawal  @ CENTURY THEATRES 44 0 CENTURY THEATRES SACRAMENTO CA US","-8.4","","","166.67"
"3/18/2024","","DEBIT","Withdrawal  @ CNK*CINEMARK.COM 44 0 CNK*CINEMARK.COM 800-246-3627 CA US","-34.28","","","132.39"
"3/18/2024","","DEBIT","Withdrawal  @ 1707 J ST 0 TARGET STORE T-3 Sacramento CA US","-21.1","","","111.29"
"3/18/2024","","DEBIT","Withdrawal  @ SACRAMENTO NATURAL 0 SACRAMENTO NATUR SACRAMENTO CA US","-58","","","53.29"
"3/19/2024","","DEBIT","Withdrawal  @ BURGERS AND BREW MI 0 BURGERS AND BREW SACRAMENTO CA US","-46.09","","","7.2"
"3/19/2024","","DEBIT","Withdrawal  @ CITYOFSAC IPS PKGME 0 CITYOFSAC IPS PK SACRAMENTO CA US","-1.75","","","5.45"
"3/19/2024","","DEBIT","Withdrawal  @ SPOTIFY 0 SPOTIFY 877-778-1161 NY US","-10.99","","","-5.54"
"3/19/2024","","CREDIT","Checking Deposit Overdraft transfer from ****190-S0","","200","","194.46"
"3/20/2024","","DEBIT","Withdrawal  @ BONFARE MARKET #33 0 BONFARE MARKET # SACRAMENTO CA US","-4.99","","","189.47"
"3/20/2024","","DEBIT","Withdrawal  @ REGALA866-651-8724 0 REGALA866-651-87 RANCHO SANTA CA US","-14.42","","","175.05"
"3/21/2024","","DEBIT","Withdrawal  @ BONFARE MARKET #33 0 BONFARE MARKET # SACRAMENTO CA US","-4.99","","","170.06"
"3/21/2024","","DEBIT","Withdrawal  @ TST* PIZZASAURUS RE 0 TST* PIZZASAURUS Sacramento CA US","-4.87","","","165.19"
"3/21/2024","","DEBIT","Withdrawal  @ TST* PIZZASAURUS RE 0 TST* PIZZASAURUS Sacramento CA US","-3.87","","","161.32"
"3/22/2024","","DEBIT","Withdrawal  @ SQ *TEMPLE COFFEE 0 SQ *TEMPLE COFFE Sacramento CA US","-28.92","","","132.4"
"3/22/2024","","DEBIT","Withdrawal  @ SACRAMENTO NATURAL 0 SACRAMENTO NATUR SACRAMENTO CA US","-50.59","","","81.81"
"3/23/2024","","DEBIT","Withdrawal  @ APPLE CASH SENT MON 0 APPLE CASH SENT 1INFINITELOOPCA US","-6","","","75.81"
"3/23/2024","","DEBIT","Withdrawal  @ NETFLIX COM 0 NETFLIX COM LOS GATOS CA US","-15.49","","","60.32"
"3/23/2024","","DEBIT","Withdrawal  @ SACRAMENTO NATURAL 0 SACRAMENTO NATUR SACRAMENTO CA US","-56.73","","","3.59"
"3/24/2024","","DEBIT","Withdrawal  @ CASH APP*MOON MAGIC 0 CASH APP*MOON MA 800-9691940 CA US","-25","","","-21.41"
"3/24/2024","","CREDIT","Checking Deposit Overdraft transfer from ****190-S0","","200","","178.59"
"3/24/2024","","DEBIT","Withdrawal  @ AUTOZONE 5593 1900 0 AUTOZONE 5593 1 SACRAMENTO CA US","-342.88","","","-164.29"
"3/24/2024","","CREDIT","Checking Deposit Overdraft transfer from ****190-S0","","400","","235.71"
"3/24/2024","","DEBIT","Withdrawal  @ 5810 FOLSOM BLVD 0 CORTI BROTHERS SACRAMENTO CA US","-59.89","","","175.82"
"3/24/2024","","DEBIT","Withdrawal  @ PETCO 1343 0 PETCO 1343 SACRAMENTO CA US","-28.26","","","147.56"
"3/24/2024","","DEBIT","Withdrawal  @ AUTOZONE 5597 5501 0 AUTOZONE 5597 5 SACRAMENTO CA US","-27.72","","","119.84"
"3/24/2024","","DEBIT","Withdrawal  @ SQ *THE ALLSPICERY 0 SQ *THE ALLSPICE Sacramento CA US","-39.55","","","80.29"
"3/24/2024","","DEBIT","Withdrawal  @ SQ *CHOCOLATE FISH 0 SQ *CHOCOLATE FI Sacramento CA US","-12.85","","","67.44"
"3/24/2024","","DEBIT","Withdrawal  @ FLOWCHART FUN PRO 0 FLOWCHART FUN PR HTTPSFLOWCHARNC US","-3","","","64.44"
"3/25/2024","","DEBIT","Withdrawal  @ ORBIT WASH 0 ORBIT WASH SACRAMENTO CA US","-2","","","62.44"
"3/25/2024","","DEBIT","Withdrawal  @ SAFEWAY #2242 0 SAFEWAY #2242 SACRAMENTO CA US","-11.79","","","50.65"
"3/25/2024","","DEBIT","Withdrawal  @ WALGREENS STORE 140 0 WALGREENS STORE SACRAMENTO CA US","-5.97","","","44.68"
"3/25/2024","","DEBIT","Withdrawal  @ WALGREENS STORE 140 0 WALGREENS STORE SACRAMENTO CA US","-27.81","","","16.87"
"3/25/2024","","DEBIT","Withdrawal  @ AUTOZONE 5601 5305 0 AUTOZONE 5601 5 SACRAMENTO CA US","-15.19","","","1.68"
"3/25/2024","","DEBIT","Withdrawal  @ 5810 FOLSOM BLVD 0 CORTI BROTHERS SACRAMENTO CA US","-72.72","","","-71.04"
"3/25/2024","","CREDIT","Checking Deposit Overdraft transfer from ****190-S0","","200","","128.96"
"3/26/2024","","DEBIT","Withdrawal  @ HARBOR FREIGHT TOOL 0 HARBOR FREIGHT T SACRAMENTO CA US","-4.34","","","124.62"
"3/26/2024","","DEBIT","Withdrawal  @ AMZN Mktp US*RA3Q10 0 AMZN Mktp US*RA3 Amzn.com/billWA US","-9.05","","","115.57"
"3/26/2024","","DEBIT","Withdrawal  @ SQ *TEMPLE COFFEE 0 SQ *TEMPLE COFFE Sacramento CA US","-5.25","","","110.32"
"3/26/2024","","DEBIT","Withdrawal  @ APPLE.COM/BILL 0 APPLE.COM/BILL 866-712-7753 CA US","-12.99","","","97.33"
"3/26/2024","","DEBIT","Withdrawal  @ 809 20TH ST 0 BONFARE MARKET # SACRAMENTO CA US","-7.71","","","89.62"
"3/28/2024","","DEBIT","Withdrawal  @ CITYOFSAC IPS PKGME 0 CITYOFSAC IPS PK SACRAMENTO CA US","-1.75","","","87.87"
"3/28/2024","","CREDIT","Checking Deposit  @ G1 Online Transfer 'STD' 800.00 from share 0","","800","","887.87"
"3/29/2024","","DEBIT","Withdrawal  @ BONFARE MARKET #33 0 BONFARE MARKET # SACRAMENTO CA US","-7.71","","","880.16"
"3/29/2024","","DEBIT","Withdrawal-ACH-A-1096016 ATT (Payment)","-79.99","","","800.17"
"3/29/2024","","DEBIT","Withdrawal-ACH-A-990166 WEBHomeRiver Group (WEB PMTS)","-755","","","45.17"
"3/29/2024","","DEBIT","Withdrawal  @ TST* THE GOLDEN BEA 0 TST* THE GOLDEN Sacramento CA US","-6.49","","","38.68"
"3/29/2024","","DEBIT","Withdrawal  @ TST* THE GOLDEN BEA 0 TST* THE GOLDEN Sacramento CA US","-9.5","","","29.18"
"3/29/2024","","DEBIT","Withdrawal  @ TST* THE GOLDEN BEA 0 TST* THE GOLDEN Sacramento CA US","-9.5","","","19.68"
"3/29/2024","","DEBIT","Withdrawal  @ SQ *TEMPLE COFFEE 0 SQ *TEMPLE COFFE Sacramento CA US","-17.65","","","2.03"
"3/29/2024","","CREDIT","Checking Deposit  @ G1 Online Transfer 'STD' 80.00 from share 0","","80","","82.03"
"3/29/2024","","DEBIT","Withdrawal  @ VOCLR.IT 0 VOCLR.IT SALISBURY GB GB","-10.09","","","71.94"
"3/29/2024","","CREDIT","ISA Single-Currency Fee Assessed = 0.10 on 9.99 - Recurring or Installment payment","","0","","0.0"
"3/30/2024","","DEBIT","Withdrawal  @ BONFARE MARKET #33 0 BONFARE MARKET # SACRAMENTO CA US","-7.71","","","64.23"
"3/30/2024","","DEBIT","Withdrawal  @ ATMX031258 2315 J ST CSSI0 EFT Sacramento CA US","-43","","","21.23"
"3/30/2024","","CREDIT","Checking Deposit  @ G1 Online Transfer 40.00 from LV 1","","40","","61.23"
"3/30/2024","","DEBIT","Withdrawal  @ BANDCAMP RHYMESA 0 BANDCAMP RHYMESA San Jose CA US","-1.29","","","59.94"
"3/30/2024","","DEBIT","Withdrawal ATM:Fee: ATM FEE DRAFT WITHDRAWAL Trace #141947","-2","","","57.94"
"3/30/2024","","CREDIT","ATM FEE DRAFT WITHDRAWAL Trace #141947 1 @ $2.00","","0","","0.0"
"3/30/2024","","DEBIT","Withdrawal  @ SQ *CAFE XOCOLAT 0 SQ *CAFE XOCOLAT SACRAMENTO CA US","-25.04","","","32.9"
"3/31/2024","","CREDIT","Checking Deposit  @ G1 Online Transfer 'STD' 15.00 from share 0","","15","","47.9"
"3/31/2024","","DEBIT","Withdrawal  @ EMBRACE PET INSURAN 0 EMBRACE PET INSU HELLO@EMBRACEOH US","-17.89","","","30.01"
"3/31/2024","","CREDIT","Checking Deposit  @ G1 Online Transfer 50.00 from LV 1","","50","","80.01"
"4/1/2024","","DEBIT","Withdrawal  @ GOOGLE GSUITE bark 0 GOOGLE GSUITE b 650-2530000 CA US","-14.4","","","65.61"
"4/1/2024","","DEBIT","Withdrawal  @ SAFEWAY #2242 0 SAFEWAY #2242 SACRAMENTO CA US","-40.17","","","25.44"
"4/1/2024","","DEBIT","Withdrawal  @ SOUNDCLOUD INC 0 SOUNDCLOUD INC 176-3257837 NY US","-16","","","9.44"
"4/2/2024","","DEBIT","Withdrawal  @ APPLE.COM/BILL 0 APPLE.COM/BILL 866-712-7753 CA US","-2.99","","","6.45"
"4/3/2024","","CREDIT","Checking Deposit  @ G1 Online Transfer 85.00 from LV 1","","85","","91.45"
"4/3/2024","","DEBIT","Withdrawal  @ VENMO* Marc 0 VENMO* Marc Visa Direct NY US","-90","","","1.45"
"4/5/2024","","DEBIT","Withdrawal-ACH-A-861479 GEICO (PREM COLL)","-52.24","","","-50.79"
"4/5/2024","","CREDIT","Checking Deposit Overdraft transfer from ****190-S0","","200","","149.21"
"4/5/2024","","DEBIT","Withdrawal  @ SQ *TEMPLE COFFEE 0 SQ *TEMPLE COFFE Sacramento CA US","-9.75","","","139.46"
"4/5/2024","","DEBIT","Withdrawal  @ SACRAMENTO NATURAL 0 SACRAMENTO NATUR SACRAMENTO CA US","-3.96","","","135.5"
"4/6/2024","","DEBIT","Withdrawal  @ Amazon Prime*CQ5U56 0 Amazon Prime*CQ5 Amzn.com/billWA US","-8.15","","","127.35"
"4/6/2024","","DEBIT","Withdrawal  @ BONFARE MARKET #33 0 BONFARE MARKET # SACRAMENTO CA US","-17.72","","","109.63"
"4/6/2024","","DEBIT","Withdrawal  @ SHELL SERVICE STATI 0 SHELL SERVICE ST SACRAMENTO CA US","-32.89","","","76.74"
"4/6/2024","","CREDIT","Checking Deposit Overdraft transfer from ****190-S0","","200","","276.74"
"4/6/2024","","DEBIT","Withdrawal  @ EB CYMATICS AMP SUB 0 EB CYMATICS AMP 8014137200 CA US","-29.05","","","247.69"
"4/6/2024","","DEBIT","Withdrawal  @ AZUL MEXICAN FOOD & 0 AZUL MEXICAN FOO SACRAMENTO CA US","-20.92","","","226.77"
"4/7/2024","","DEBIT","Withdrawal  @ BONFARE MARKET #33 0 BONFARE MARKET # SACRAMENTO CA US","-17.38","","","209.39"
"4/7/2024","","DEBIT","Withdrawal  @ PY *OLD SOUL AT THE 0 PY *OLD SOUL AT SACRAMENTO CA US","-11.45","","","197.94"
"4/7/2024","","DEBIT","Withdrawal  @ AMZN Mktp US*MI9ZZ0 0 AMZN Mktp US*MI9 Amzn.com/billWA US","-53.18","","","144.76"
"4/7/2024","","DEBIT","Withdrawal  @ TST* SACTO HOTBOYS 0 TST* SACTO HOTBO Sacramento CA US","-29.19","","","115.57"
"4/7/2024","","DEBIT","Withdrawal  @ AMZN Mktp US*QV1TK6 0 AMZN Mktp US*QV1 Amzn.com/billWA US","-75.02","","","40.55"
"4/7/2024","","DEBIT","Withdrawal  @ PETCO 1343 0 PETCO 1343 SACRAMENTO CA US","-14.13","","","26.42"
"4/7/2024","","DEBIT","Withdrawal  @ 5810 FOLSOM BLVD 0 CORTI BROTHERS SACRAMENTO CA US","-47.11","","","-20.69"
"4/7/2024","","CREDIT","Checking Deposit Overdraft transfer from ****190-S0","","200","","179.31"
"4/8/2024","","DEBIT","Withdrawal  @ AMAZON PRIME*LL6O03 0 AMAZON PRIME*LL6 888-802-3080 WA US","-5.99","","","173.32"
"4/8/2024","","DEBIT","Withdrawal-ACH-A-983291 WEBADVS ED SERV WEB (STUDNTLOAN)","-302.16","","","-128.84"
"4/8/2024","","CREDIT","Checking Deposit Overdraft transfer from ****190-S0","","200","","71.16"
"4/8/2024","","DEBIT","Withdrawal  @ EAST PATIO MEXICANO 0 EAST PATIO MEXIC 916-6627099 CA US","-22.65","","","48.51"
"4/8/2024","","DEBIT","Withdrawal  @ SQ *TEMPLE COFFEE? 0 SQ *TEMPLE COFFE Sacramento CA US","-18.45","","","30.06"
"4/8/2024","","DEBIT","Withdrawal  @ KOMBI HAUS MOTORS I 0 KOMBI HAUS MOTOR SACRAMENTO CA US","-165","","","-134.94"
"4/8/2024","","CREDIT","Checking Deposit Overdraft transfer from ****190-S0","","200","","65.06"
"4/8/2024","","DEBIT","Withdrawal  @ SACRAMENTO NATURAL 0 SACRAMENTO NATUR SACRAMENTO CA US","-128.79","","","-63.73"
"4/8/2024","","CREDIT","Checking Deposit Overdraft transfer from ****190-S0","","200","","136.27"
"4/9/2024","","DEBIT","Withdrawal  @ PY *OLD SOUL 40 AC 0 PY *OLD SOUL 40 SACRAMENTO CA US","-5.1","","","131.17"
"4/9/2024","","DEBIT","Withdrawal  @ AMZN Mktp US*NE9UC0 0 AMZN Mktp US*NE9 Amzn.com/billWA US","-10.86","","","120.31"
"4/9/2024","","DEBIT","Withdrawal  @ 5810 FOLSOM BLVD 0 CORTI BROTHERS SACRAMENTO CA US","-7.98","","","112.33"
"4/9/2024","","DEBIT","Withdrawal  @ TRADER JOE S #17 TR 0 TRADER JOE S #17 SACRAMENTO CA US","-6.84","","","105.49"
"4/10/2024","","DEBIT","Withdrawal  @ ZZOUNDS.COM 0 ZZOUNDS.COM 800-493-3945 NJ US","-49.75","","","55.74"
"4/10/2024","","DEBIT","Withdrawal  @ SAFEWAY #2242 0 SAFEWAY #2242 SACRAMENTO CA US","-5.99","","","49.75"
"4/11/2024","","DEBIT","Withdrawal  @ AMAZON.COM*2873Z96X 0 AMAZON.COM*2873Z SEATTLE WA US","-18.06","","","31.69"
"4/14/2024","","DEBIT","Withdrawal  @ DALEK ONE* SUBSCR 1 0 DALEK ONE* SUBSC HTTPSDALEKONEMN US","-7","","","24.69"
"4/15/2024","","CREDIT","Checking Deposit  @ G1 Online Transfer 'STD' 65.00 from share 0","","65","","89.69"
"4/15/2024","","DEBIT","Withdrawal  @ VENMO* Marc 0 VENMO* Marc Visa Direct NY US","-85","","","4.69"
"4/16/2024","","CREDIT","Checking Deposit-ACH-1088781 FRANCHISE TAX BD (CASTTAXRFD)","","296","","300.69"
"4/17/2024","","DEBIT","Withdrawal  @ SPLICE.COM* SPLICE 0 SPLICE.COM* SPLI SPLICE.COM NY US","-9.99","","","290.7"
"4/17/2024","","DEBIT","Withdrawal  @ ATMDNS39935 5401 H ST 2 CSSI0 LA GARE SACRAMENTO CA US","-93.5","","","197.2"
"4/17/2024","","DEBIT","Withdrawal ATM:Fee: ATM FEE DRAFT WITHDRAWAL Trace #41800002965","-2","","","195.2"
"4/17/2024","","CREDIT","ATM FEE DRAFT WITHDRAWAL Trace #41800002965 1 @ $2.00","","0","","0.0"
"4/18/2024","","DEBIT","Withdrawal  @ NAEMEH.COM 0 NAEMEH.COM WWW.NAEMEH.COCA US","-60","","","135.2"
"4/18/2024","","DEBIT","Withdrawal  @ DD DOORDASH NSTREET 0 DD DOORDASH NSTR 855-973-1040 CA US","-20.35","","","114.85"
"4/19/2024","","DEBIT","Withdrawal  @ TST* THE FLAMINGO H 0 TST* THE FLAMING SACRAMENTO CA US","-18.94","","","95.91"
"4/19/2024","","DEBIT","Withdrawal  @ SQ *TEMPLE COFFEE 0 SQ *TEMPLE COFFE Sacramento CA US","-12.88","","","83.03"
"4/19/2024","","DEBIT","Withdrawal  @ SPOTIFY 0 SPOTIFY 877-778-1161 NY US","-10.99","","","72.04"
"4/20/2024","","DEBIT","Withdrawal  @ TST* TAQUERIA JALIS 0 TST* TAQUERIA JA Sacramento CA US","-39.39","","","32.65"
"4/20/2024","","DEBIT","Withdrawal  @ TST* TAQUERIA JALIS 0 TST* TAQUERIA JA Sacramento CA US","-7.5","","","25.15"
"4/20/2024","","DEBIT","Withdrawal  @ SQ *TEMPLE COFFEE 0 SQ *TEMPLE COFFE Sacramento CA US","-13.97","","","11.18"
"4/20/2024","","DEBIT","Withdrawal  @ SACRAMENTO NATURAL 0 SACRAMENTO NATUR SACRAMENTO CA US","-92.1","","","-80.92"
"4/20/2024","","CREDIT","Checking Deposit Overdraft transfer from ****190-S0","","200","","119.08"
"4/20/2024","","DEBIT","Withdrawal  @ SQ *WT COFFEE ROAST 0 SQ *WT COFFEE RO Sactamento CA US","-4.9","","","114.18"
"4/21/2024","","DEBIT","Withdrawal  @ CNK*CINEMARK.COM 44 0 CNK*CINEMARK.COM 800-246-3627 CA US","-30.28","","","83.9"
"4/21/2024","","DEBIT","Withdrawal  @ CENTURY THEATRES 44 0 CENTURY THEATRES SACRAMENTO CA US","-11.35","","","72.55"
"4/21/2024","","DEBIT","Withdrawal  @ PADDLE.NET* KAIBER 0 PADDLE.NET* KAIB PADDLE.COM NY US","-5","","","67.55"
"4/21/2024","","DEBIT","Withdrawal  @ SQ *TEMPLE COFFEE? 0 SQ *TEMPLE COFFE Sacramento CA US","-14.49","","","53.06"
"4/22/2024","","DEBIT","Withdrawal  @ APPLE.COM/BILL 0 APPLE.COM/BILL 866-712-7753 CA US","-12.99","","","40.07"
"4/22/2024","","DEBIT","Withdrawal  @ ATMDNS39935 5401 H ST 2 CSSI0 LA GARE SACRAMENTO CA US","-53.5","","","-13.43"
"4/22/2024","","CREDIT","Checking Deposit Overdraft transfer from ****190-S0","","200","","186.57"
"4/22/2024","","DEBIT","Withdrawal  @ PETCO 1343 0 PETCO 1343 SACRAMENTO CA US","-24.23","","","162.34"
"4/22/2024","","DEBIT","Withdrawal  @ 5810 FOLSOM BLVD 0 CORTI BROTHERS SACRAMENTO CA US","-92.63","","","69.71"
"4/22/2024","","DEBIT","Withdrawal ATM:Fee: ATM FEE DRAFT WITHDRAWAL Trace #42300003256","-2","","","67.71"
"4/22/2024","","CREDIT","ATM FEE DRAFT WITHDRAWAL Trace #42300003256 1 @ $2.00","","0","","0.0"
"4/23/2024","","DEBIT","Withdrawal  @ NETFLIX COM 0 NETFLIX COM LOS GATOS CA US","-15.49","","","52.22"
"4/23/2024","","DEBIT","Withdrawal  @ SHELL OIL 574430170 0 SHELL OIL 574430 SACRAMENTO CA US","-54.07","","","-1.85"
"4/23/2024","","CREDIT","Checking Deposit Overdraft transfer from ****190-S0","","200","","198.15"
"4/23/2024","","CREDIT","Checking Deposit-ACH-A-997496 TPG PRODUCTS (SBTPG LLC)","","564","","762.15"
"4/23/2024","","DEBIT","Withdrawal  @ DD DOORDASH NSTREET 0 DD DOORDASH NSTR 855-973-1040 CA US","-20.35","","","741.8"
"4/24/2024","","DEBIT","Withdrawal-ACH-A-1064712 WEBSMUD (WEB PAY)","-120.55","","","621.25"
"4/24/2024","","DEBIT","Withdrawal  @ SQ *TEMPLE COFFEE 0 SQ *TEMPLE COFFE Sacramento CA US","-21.91","","","599.34"
"4/24/2024","","DEBIT","Withdrawal  @ TRYOTTER* PALMITA 0 TRYOTTER* PALMIT TRYOTTER.COM CA US","-10.82","","","588.52"
"4/24/2024","","DEBIT","Withdrawal  @ FLOWCHART FUN PRO 0 FLOWCHART FUN PR HTTPSFLOWCHARNC US","-3","","","585.52"
"4/25/2024","","DEBIT","Withdrawal  @ BONFARE MARKET #33 0 BONFARE MARKET # SACRAMENTO CA US","-6.29","","","579.23"
"4/25/2024","","DEBIT","Withdrawal  @ SQ *TEMPLE COFFEE 0 SQ *TEMPLE COFFE Sacramento CA US","-21.4","","","557.83"
"4/25/2024","","CREDIT","Checking Deposit  @ G1 Online Transfer 'STD' 1100.00 from share 0","","1100","","1657.83"
"4/25/2024","","DEBIT","Withdrawal  @ KOMBI HAUS MOTORS I 0 KOMBI HAUS MOTOR SACRAMENTO CA US","-1323.82","","","334.01"
"4/25/2024","","DEBIT","Withdrawal  @ SACRAMENTO NATURAL 0 SACRAMENTO NATUR SACRAMENTO CA US","-86.21","","","247.8"
"4/26/2024","","DEBIT","Withdrawal  @ SQ *TEMPLE COFFEE 0 SQ *TEMPLE COFFE Sacramento CA US","-10.25","","","237.55"
"4/27/2024","","DEBIT","Withdrawal  @ LYFT RIDE THU 4PM 0 LYFT RIDE THU 855-865-9553 CA US","-21.99","","","215.56"
"4/27/2024","","DEBIT","Withdrawal  @ SQ *COLONIAL THEATE 0 SQ *COLONIAL THE SACRAMENTO CA US","-6","","","209.56"
"4/27/2024","","DEBIT","Withdrawal  @ SQ *SUBPHONIC EVENT 0 SQ *SUBPHONIC EV ORANGEVALE CA US","-9.2","","","200.36"
"4/27/2024","","DEBIT","Withdrawal  @ AZUL MEXICAN FOOD & 0 AZUL MEXICAN FOO SACRAMENTO CA US","-22.61","","","177.75"
"4/27/2024","","DEBIT","Withdrawal  @ SQ *TEMPLE COFFEE? 0 SQ *TEMPLE COFFE Sacramento CA US","-20.5","","","157.25"
"4/28/2024","","DEBIT","Withdrawal  @ TST* SACYARD COMMUN 0 TST* SACYARD COM Sacramento CA US","-21.67","","","135.58"
"4/28/2024","","DEBIT","Withdrawal  @ TST* SACYARD COMMUN 0 TST* SACYARD COM Sacramento CA US","-24.8","","","110.78"
"4/28/2024","","DEBIT","Withdrawal  @ TST* SACYARD COMMUN 0 TST* SACYARD COM Sacramento CA US","-10.88","","","99.9"
"4/28/2024","","DEBIT","Withdrawal  @ SACRAMENTO NATURAL 0 SACRAMENTO NATUR SACRAMENTO CA US","-16.24","","","83.66"
"4/29/2024","","DEBIT","Withdrawal-ACH-A-1096016 ATT (Payment)","-79.99","","","3.67"
"4/29/2024","","DEBIT","Withdrawal  @ 809 20TH ST 0 BONFARE MARKET # SACRAMENTO CA US","-9.95","","","-6.28"
"4/29/2024","","CREDIT","Checking Deposit Overdraft transfer from ****190-S0","","200","","193.72"
"4/29/2024","","DEBIT","Withdrawal  @ ParkWhiz Inc. 0 ParkWhiz Inc. Chicago IL US","-11.09","","","182.63"
"4/29/2024","","DEBIT","Withdrawal  @ 5810 FOLSOM BLVD 0 CORTI BROTHERS SACRAMENTO CA US","-97.39","","","85.24"
"4/29/2024","","DEBIT","Withdrawal  @ POSEYS GENERAL STOR 0 POSEYS GENERAL S SACRAMENTO CA US","-2.58","","","82.66"
"4/29/2024","","DEBIT","Withdrawal  @ SACRAMENTO NATURAL 0 SACRAMENTO NATUR SACRAMENTO CA US","-31.39","","","51.27"
"4/29/2024","","CREDIT","Checking Deposit Overdraft transfer from ****190-S0","","200","","251.27"
"4/29/2024","","DEBIT","Withdrawal  @ VOCLR.IT 0 VOCLR.IT SALISBURY GB GB","-10.09","","","241.18"
"4/29/2024","","CREDIT","ISA Single-Currency Fee Assessed = 0.10 on 9.99 - Recurring or Installment payment","","0","","0.0"
"4/30/2024","","DEBIT","Withdrawal  @ CITYOFSAC IPS PKGME 0 CITYOFSAC IPS PK SACRAMENTO CA US","-11.5","","","229.68"
"4/30/2024","","DEBIT","Withdrawal  @ CAPITOL ACE HARDWAR 0 CAPITOL ACE HARD SACRAMENTO CA US","-43.49","","","186.19"
"4/30/2024","","DEBIT","Withdrawal  @ BONFARE MARKET #33 0 BONFARE MARKET # SACRAMENTO CA US","-3.9","","","182.29"
"4/30/2024","","DEBIT","Withdrawal  @ ATMDNS39935 5401 H ST 2 CSSI0 LA GARE SACRAMENTO CA US","-33.5","","","148.79"
"4/30/2024","","DEBIT","Withdrawal ATM:Fee: ATM FEE DRAFT WITHDRAWAL Trace #43100003509","-2","","","146.79"
"4/30/2024","","CREDIT","ATM FEE DRAFT WITHDRAWAL Trace #43100003509 1 @ $2.00","","0","","0.0"
"5/1/2024","","DEBIT","Withdrawal  @ BONFARE MARKET #33 0 BONFARE MARKET # SACRAMENTO CA US","-7.89","","","138.9"
"5/1/2024","","DEBIT","Withdrawal  @ GOOGLE GSUITE bark 0 GOOGLE GSUITE b 650-2530000 CA US","-14.4","","","124.5"
"5/1/2024","","DEBIT","Withdrawal  @ EMBRACE PET INSURAN 0 EMBRACE PET INSU HELLO@EMBRACEOH US","-17.89","","","106.61"
"5/1/2024","","DEBIT","Withdrawal  @ SOUNDCLOUD INC 0 SOUNDCLOUD INC 176-3257837 NY US","-16","","","90.61"
"5/1/2024","","DEBIT","Withdrawal  @ SACRAMENTO NATURAL 0 SACRAMENTO NATUR SACRAMENTO CA US","-57.56","","","33.05"
"5/1/2024","","DEBIT","Withdrawal  @ APPLE.COM/BILL 0 APPLE.COM/BILL 866-712-7753 CA US","-2.99","","","30.06"
"5/2/2024","","DEBIT","Withdrawal  @ BONFARE MARKET #33 0 BONFARE MARKET # SACRAMENTO CA US","-6.62","","","23.44"
"5/2/2024","","DEBIT","Withdrawal  @ PY *OLD SOUL AT THE 0 PY *OLD SOUL AT SACRAMENTO CA US","-20.6","","","2.84"
"5/2/2024","","CREDIT","Checking Deposit  @ G1 Online Transfer 'STD' 500.00 from share 0","","500","","502.84"
"5/2/2024","","DEBIT","Withdrawal  @ VENMO* Marc 0 VENMO* Marc Visa Direct NY US","-500","","","2.84"
"5/4/2024","","CREDIT","Checking Deposit  @ ATMGO864654 2820 R STREET CSSI0 GOLDEN 1 CU SACRAMENTO CA US","","225","","227.84"
"5/6/2024","","DEBIT","Withdrawal  @ Amazon Prime*JQ2XX3 0 Amazon Prime*JQ2 Amzn.com/billWA US","-8.15","","","219.69"
"5/6/2024","","DEBIT","Withdrawal-ACH-A-861479 GEICO (PREM COLL)","-52.24","","","167.45"
"5/6/2024","","DEBIT","Withdrawal  @ ATMDNS39935 5401 H ST 2 CSSI0 LA GARE SACRAMENTO CA US","-53.5","","","113.95"
"5/6/2024","","DEBIT","Withdrawal  @ SQ *TEMPLE COFFEE 0 SQ *TEMPLE COFFE Sacramento CA US","-15.3","","","98.65"
"5/6/2024","","DEBIT","Withdrawal ATM:Fee: ATM FEE DRAFT WITHDRAWAL Trace #43700003704","-2","","","96.65"
"5/6/2024","","CREDIT","ATM FEE DRAFT WITHDRAWAL Trace #43700003704 1 @ $2.00","","0","","0.0"
"5/7/2024","","DEBIT","Withdrawal  @ LOVE LAUNDRY 0 LOVE LAUNDRY SACRAMENTO CA US","-2.5","","","94.15"
"5/7/2024","","DEBIT","Withdrawal  @ LOVE LAUNDRY 0 LOVE LAUNDRY SACRAMENTO CA US","-20","","","74.15"
"5/7/2024","","DEBIT","Withdrawal  @ LOVE LAUNDRY 0 LOVE LAUNDRY SACRAMENTO CA US","-9.85","","","64.3"
"5/7/2024","","DEBIT","Withdrawal  @ BONFARE MARKET #33 0 BONFARE MARKET # SACRAMENTO CA US","-7.71","","","56.59"
"5/7/2024","","DEBIT","Withdrawal-ACH-A-990166 WEBHomeRiver Group (WEB PMTS)","-780","","","-723.41"
"5/7/2024","","CREDIT","Checking Deposit Overdraft transfer from ****190-S0","","800","","76.59"
"5/7/2024","","DEBIT","Withdrawal  @ LYFT *RIDE TUE 2P 0 LYFT *RIDE TUE LYFT.COM CA US","-16.9","","","59.69"
"5/8/2024","","DEBIT","Withdrawal  @ BONFARE MARKET #33 0 BONFARE MARKET # SACRAMENTO CA US","-7.71","","","51.98"
"5/8/2024","","DEBIT","Withdrawal  @ SQ *TEMPLE COFFEE 0 SQ *TEMPLE COFFE Sacramento CA US","-15.24","","","36.74"
"5/8/2024","","DEBIT","Withdrawal  @ 5810 FOLSOM BLVD 0 CORTI BROTHERS SACRAMENTO CA US","-20.51","","","16.23"
"5/8/2024","","DEBIT","Withdrawal  @ PETCO 1343 0 PETCO 1343 SACRAMENTO CA US","-47.23","","","-31"
"5/8/2024","","CREDIT","Checking Deposit Overdraft transfer from ****190-S0","","200","","169"
"5/9/2024","","DEBIT","Withdrawal  @ SQ *TEMPLE COFFEE 0 SQ *TEMPLE COFFE Sacramento CA US","-10.95","","","158.05"
"5/9/2024","","DEBIT","Withdrawal  @ AMZN Mktp US*5L1XM6 0 AMZN Mktp US*5L1 Amzn.com/billWA US","-44.57","","","113.48"
"5/9/2024","","DEBIT","Withdrawal  @ PADDLE.NET* KAIBER 0 PADDLE.NET* KAIB PADDLE.COM NY US","-15","","","98.48"
"5/9/2024","","DEBIT","Withdrawal  @ PADDLE.NET* KAIBER 0 PADDLE.NET* KAIB PADDLE.COM NY US","-15","","","83.48"
"5/10/2024","","DEBIT","Withdrawal  @ BONFARE MARKET #33 0 BONFARE MARKET # SACRAMENTO CA US","-7.71","","","75.77"
"5/10/2024","","DEBIT","Withdrawal  @ SQ *TEMPLE COFFEE 0 SQ *TEMPLE COFFE Sacramento CA US","-11.38","","","64.39"
"5/11/2024","","CREDIT","Checking Deposit  @ PADDLE.NET* KAIBER 0 PADDLE.NET* KAIB PADDLE.COM NY US","","5","","69.39"
"5/11/2024","","DEBIT","Withdrawal  @ BONFARE MARKET #33 0 BONFARE MARKET # SACRAMENTO CA US","-7.71","","","61.68"
"5/11/2024","","CREDIT","Checking Deposit Overdraft transfer from ****190-S0","","200","","261.68"
"5/11/2024","","DEBIT","Withdrawal  @ ZZOUNDS.COM 0 ZZOUNDS.COM 800-493-3945 NJ US","-49.75","","","211.93"
"5/11/2024","","DEBIT","Withdrawal  @ AZUL MEXICAN FOOD & 0 AZUL MEXICAN FOO SACRAMENTO CA US","-32.56","","","179.37"
"5/11/2024","","DEBIT","Withdrawal  @ SQ *TEMPLE COFFEE 0 SQ *TEMPLE COFFE Sacramento CA US","-12.71","","","166.66"
"5/11/2024","","DEBIT","Withdrawal  @ ATMP375734 390 GRASS VALLEY HW CSSI0 HWY 49 GAS A-375 AUBURN CA US","-63.5","","","103.16"
"5/11/2024","","DEBIT","Withdrawal  @ NEVADA CITY CHOC 0 NEVADA CITY CHOC NEVADA CITY CA US","-10.56","","","92.6"
"5/11/2024","","DEBIT","Withdrawal  @ SQ *MIDTOWN FARMERS 0 SQ *MIDTOWN FARM Sacramento CA US","-17.94","","","74.66"
"5/11/2024","","DEBIT","Withdrawal ATM:Fee: ATM FEE DRAFT WITHDRAWAL Trace #432","-2","","","72.66"
"5/11/2024","","CREDIT","ATM FEE DRAFT WITHDRAWAL Trace #432 1 @ $2.00","","0","","0.0"
"5/12/2024","","DEBIT","Withdrawal  @ TST* FRIAR TUCKS RE 0 TST* FRIAR TUCKS Nevada City CA US","-26.38","","","46.28"
"5/12/2024","","CREDIT","Checking Deposit Overdraft transfer from ****190-S0","","200","","246.28"
"5/12/2024","","DEBIT","Withdrawal  @ TST* FRIAR TUCKS RE 0 TST* FRIAR TUCKS Nevada City CA US","-15.09","","","231.19"
"5/12/2024","","DEBIT","Withdrawal  @ TST* FRIAR TUCKS RE 0 TST* FRIAR TUCKS Nevada City CA US","-16.09","","","215.1"
"5/12/2024","","DEBIT","Withdrawal  @ TST* TROPICS SACRAM 0 TST* TROPICS SAC SACRAMENTO CA US","-18.57","","","196.53"
"5/12/2024","","DEBIT","Withdrawal  @ SQ *TEMPLE COFFEE 0 SQ *TEMPLE COFFE Sacramento CA US","-25.9","","","170.63"
"5/13/2024","","DEBIT","Withdrawal  @ DD DOORDASH SHANGHA 0 DD DOORDASH SHAN 855-973-1040 CA US","-38.77","","","131.86"
"5/13/2024","","DEBIT","Withdrawal  @ SQ *TEMPLE COFFEE 0 SQ *TEMPLE COFFE Sacramento CA US","-15.52","","","116.34"
"5/14/2024","","DEBIT","Withdrawal  @ BONFARE MARKET #33 0 BONFARE MARKET # SACRAMENTO CA US","-4.99","","","111.35"
"5/14/2024","","DEBIT","Withdrawal  @ DALEK ONE* SUBSCR 1 0 DALEK ONE* SUBSC HTTPSDALEKONEMN US","-7","","","104.35"
"5/16/2024","","DEBIT","Withdrawal  @ Amazon.com*UW4KH05X 0 Amazon.com*UW4KH Amzn.com/billWA US","-38.89","","","65.46"
"5/17/2024","","DEBIT","Withdrawal  @ SPLICE.COM* SPLICE 0 SPLICE.COM* SPLI SPLICE.COM NY US","-9.99","","","55.47"
"5/17/2024","","CREDIT","Checking Deposit  @ Mobile Deposit","","750","","805.47"
"5/19/2024","","DEBIT","Withdrawal  @ LYFT *RIDE SAT 9P 0 LYFT *RIDE SAT LYFT.COM CA US","-16.72","","","788.75"
"5/19/2024","","DEBIT","Withdrawal  @ EB STILLDREAM FESTI 0 EB STILLDREAM FE 8014137200 CA US","-28.52","","","760.23"
"5/19/2024","","DEBIT","Withdrawal  @ EB STILLDREAM FESTI 0 EB STILLDREAM FE 8014137200 CA US","-28.52","","","731.71"
"5/19/2024","","DEBIT","Withdrawal  @ SQ *ON THE Y 0 SQ *ON THE Y SACRAMENTO CA US","-17.11","","","714.6"
"5/19/2024","","DEBIT","Withdrawal  @ SPOTIFY 0 SPOTIFY 877-778-1161 NY US","-10.99","","","703.61"
"5/19/2024","","DEBIT","Withdrawal  @ 1609 16TH ST 0 RAMEN 101 MIDTOW SACRAMENTO CA US","-32.54","","","671.07"
"5/19/2024","","DEBIT","Withdrawal  @ LYFT *RIDE SAT 11 0 LYFT *RIDE SAT LYFT.COM CA US","-16.68","","","654.39"
"5/19/2024","","DEBIT","Withdrawal  @ SACRAMENTO NATURAL 0 SACRAMENTO NATUR SACRAMENTO CA US","-40.42","","","613.97"
"5/20/2024","","DEBIT","Withdrawal  @ BACON & BUTTER 0 BACON & BUTTER SACRAMENTO CA US","-75.6","","","538.37"
"5/20/2024","","DEBIT","Withdrawal  @ BACON & BUTTER 0 BACON & BUTTER SACRAMENTO CA US","-36.17","","","502.2"
"5/20/2024","","DEBIT","Withdrawal  @ SHELL OIL 574430170 0 SHELL OIL 574430 SACRAMENTO CA US","-31.53","","","470.67"
"5/20/2024","","DEBIT","Withdrawal  @ SACRAMENTO NATURAL 0 SACRAMENTO NATUR SACRAMENTO CA US","-13.73","","","456.94"
"5/20/2024","","DEBIT","Withdrawal  @ 2005 Marconi Ave 0 7-ELEVEN Sacramento CA US","-20","","","436.94"
"5/20/2024","","DEBIT","Withdrawal  @ TRADER JOE S #17 TR 0 TRADER JOE S #17 SACRAMENTO CA US","-57.39","","","379.55"
"5/21/2024","","DEBIT","Withdrawal  @ TST* ESTELLE BAKERY 0 TST* ESTELLE BAK Sacramento CA US","-21.45","","","358.1"
"5/21/2024","","DEBIT","Withdrawal  @ TST* HOOK & LADDER 0 TST* HOOK & LADD SACRAMENTO CA US","-25.42","","","332.68"
"5/21/2024","","DEBIT","Withdrawal  @ PADDLE.NET* KAIBER 0 PADDLE.NET* KAIB PADDLE.COM NY US","-15","","","317.68"
"5/21/2024","","DEBIT","Withdrawal  @ SOCAL'S TAVERN 0 SOCAL'S TAVERN SACRAMENTO CA US","-17.23","","","300.45"
"5/22/2024","","DEBIT","Withdrawal  @ CITYOFSAC IPS PKGME 0 CITYOFSAC IPS PK SACRAMENTO CA US","-1.75","","","298.7"
"5/22/2024","","DEBIT","Withdrawal  @ BONFARE MARKET #33 0 BONFARE MARKET # SACRAMENTO CA US","-7.71","","","290.99"
"5/22/2024","","DEBIT","Withdrawal-ACH-A-1064712 WEBSMUD (WEB PAY)","-133.41","","","157.58"
"5/22/2024","","DEBIT","Withdrawal  @ AMZN Mktp US*CQ3KN9 0 AMZN Mktp US*CQ3 Amzn.com/billWA US","-5.85","","","151.73"
"5/22/2024","","DEBIT","Withdrawal  @ APPLE.COM/BILL 0 APPLE.COM/BILL 866-712-7753 CA US","-12.99","","","138.74"
"5/22/2024","","DEBIT","Withdrawal  @ ATMDNS39935 5401 H ST 2 CSSI0 LA GARE SACRAMENTO CA US","-53.5","","","85.24"
"5/22/2024","","DEBIT","Withdrawal  @ AMZN Mktp US*8O1AS4 0 AMZN Mktp US*8O1 Amzn.com/billWA US","-46.7","","","38.54"
"5/22/2024","","DEBIT","Withdrawal ATM:Fee: ATM FEE DRAFT WITHDRAWAL Trace #45300004349","-2","","","36.54"
"5/22/2024","","CREDIT","ATM FEE DRAFT WITHDRAWAL Trace #45300004349 1 @ $2.00","","0","","0.0"
"5/23/2024","","DEBIT","Withdrawal  @ BONFARE MARKET #33 0 BONFARE MARKET # SACRAMENTO CA US","-7.71","","","28.83"
"5/23/2024","","DEBIT","Withdrawal  @ NETFLIX COM 0 NETFLIX COM LOS GATOS CA US","-15.49","","","13.34"
"5/23/2024","","CREDIT","Checking Deposit Overdraft transfer from ****190-S0","","200","","213.34"
"5/23/2024","","DEBIT","Withdrawal  @ DD DOORDASH NSTREET 0 DD DOORDASH NSTR 855-973-1040 CA US","-18.81","","","194.53"
"5/24/2024","","DEBIT","Withdrawal  @ BONFARE MARKET #33 0 BONFARE MARKET # SACRAMENTO CA US","-11.61","","","182.92"
"5/24/2024","","DEBIT","Withdrawal  @ FLOWCHART FUN PRO 0 FLOWCHART FUN PR HTTPSFLOWCHARNC US","-3","","","179.92"
"5/25/2024","","DEBIT","Withdrawal  @ BONFARE MARKET #33 0 BONFARE MARKET # SACRAMENTO CA US","-7.71","","","172.21"
"5/25/2024","","DEBIT","Withdrawal  @ SQ *TEMPLE COFFEE 0 SQ *TEMPLE COFFE Sacramento CA US","-22.2","","","150.01"
"5/25/2024","","DEBIT","Withdrawal  @ TRADER JOE S #17 TR 0 TRADER JOE S #17 SACRAMENTO CA US","-64.32","","","85.69"
"5/26/2024","","DEBIT","Withdrawal  @ BONFARE MARKET #33 0 BONFARE MARKET # SACRAMENTO CA US","-6.66","","","79.03"
"5/26/2024","","DEBIT","Withdrawal  @ AZUL MEXICAN FOOD & 0 AZUL MEXICAN FOO SACRAMENTO CA US","-31.74","","","47.29"
"5/26/2024","","DEBIT","Withdrawal  @ SACRAMENTO NATURAL 0 SACRAMENTO NATUR SACRAMENTO CA US","-33","","","14.29"
"5/27/2024","","DEBIT","Withdrawal  @ TST* SELLAND FAMILY 0 TST* SELLAND FAM Sacramento CA US","-9.7","","","4.59"
"5/27/2024","","CREDIT","Checking Deposit  @ G1 Online Transfer 'STD' 800.00 from share 0","","800","","804.59"
"5/27/2024","","DEBIT","Withdrawal  @ PETCO 1343 0 PETCO 1343 SACRAMENTO CA US","-32.58","","","772.01"
"5/27/2024","","DEBIT","Withdrawal  @ TRADER JOE S #17 TR 0 TRADER JOE S #17 SACRAMENTO CA US","-62.4","","","709.61"
"5/27/2024","","DEBIT","Withdrawal  @ Amazon.com*7X5JE9EB 0 Amazon.com*7X5JE Amzn.com/billWA US","-32.58","","","677.03"
"5/27/2024","","DEBIT","Withdrawal  @ AMZN Mktp US*OG3IJ2 0 AMZN Mktp US*OG3 Amzn.com/billWA US","-38.41","","","638.62"
"5/27/2024","","DEBIT","Withdrawal  @ SHELL SERVICE STATI 0 SHELL SERVICE ST SACRAMENTO CA US","-26.81","","","611.81"
"5/27/2024","","DEBIT","Withdrawal  @ NUGGET MARKET #6 0 NUGGET MARKET #6 WEST SACRAMENCA US","-49.6","","","562.21"
"5/28/2024","","DEBIT","Withdrawal-ACH-A-1096016 ATT (Payment)","-79.99","","","482.22"
"5/28/2024","","DEBIT","Withdrawal  @ SACRAMENTO NATURAL 0 SACRAMENTO NATUR SACRAMENTO CA US","-10.35","","","471.87"
"5/28/2024","","DEBIT","Withdrawal  @ SQ *TEMPLE COFFE 0 SQ *TEMPLE COFFE SACRAMENTO CA US","-5.62","","","466.25"
"5/28/2024","","CREDIT","Checking Deposit  @ G1 Online Transfer 'STD' 300.00 from share 0","","300","","766.25"
"5/28/2024","","DEBIT","Withdrawal  @ SAFEWAY #2242 0 SAFEWAY #2242 SACRAMENTO CA US","-5.58","","","760.67"
"5/29/2024","","DEBIT","Withdrawal  @ BONFARE MARKET #33 0 BONFARE MARKET # SACRAMENTO CA US","-7.71","","","752.96"
"5/29/2024","","DEBIT","Withdrawal-ACH-A-990166 WEBHomeRiver Group (WEB PMTS)","-755","","","-2.04"
"5/29/2024","","CREDIT","Checking Deposit Overdraft transfer from ****190-S0","","200","","197.96"
"5/29/2024","","CREDIT","Checking Deposit  @ VENMO*Del Fava Marc 0 VENMO*Del Fava M New York CityNY US","","204.36","","402.32"
"5/29/2024","","CREDIT","Checking Deposit  @ VENMO*Del Fava Marc 0 VENMO*Del Fava M New York CityNY US","","147.38","","549.7"
"5/29/2024","","DEBIT","Withdrawal  @ 809 20TH ST 0 BONFARE MARKET # SACRAMENTO CA US","-7.71","","","541.99"
"5/29/2024","","DEBIT","Withdrawal  @ AIRBNB HMRE2SWDWZ 0 AIRBNB HMRE2SWD AIRBNB.COM CA US","-113.25","","","428.74"
"5/29/2024","","DEBIT","Withdrawal  @ AIRBNB HM2A8MJDXZ 0 AIRBNB HM2A8MJD AIRBNB.COM CA US","-325.2","","","103.54"
"5/29/2024","","DEBIT","Withdrawal  @ VOCLR.IT 0 VOCLR.IT SALISBURY GB GB","-10.09","","","93.45"
"5/29/2024","","CREDIT","ISA Single-Currency Fee Assessed = 0.10 on 9.99 - Recurring or Installment payment","","0","","0.0"
"5/30/2024","","DEBIT","Withdrawal  @ APPLE.COM/BILL 0 APPLE.COM/BILL 866-712-7753 CA US","-12.99","","","80.46"
"5/30/2024","","DEBIT","Withdrawal  @ TRADER JOE S #17 TR 0 TRADER JOE S #17 SACRAMENTO CA US","-5.37","","","75.09"
"5/31/2024","","DEBIT","Withdrawal  @ EMBRACE PET INSURAN 0 EMBRACE PET INSU HELLO@EMBRACEOH US","-17.89","","","57.2"
"5/31/2024","","DEBIT","Withdrawal  @ TRADER JOE S #17 TR 0 TRADER JOE S #17 SACRAMENTO CA US","-17.19","","","40.01"
"6/1/2024","","DEBIT","Withdrawal  @ GOOGLE GSUITE bark 0 GOOGLE GSUITE b 650-2530000 CA US","-14.4","","","25.61"
"6/1/2024","","DEBIT","Withdrawal  @ APPLE.COM/BILL 0 APPLE.COM/BILL 866-712-7753 CA US","-2.99","","","22.62"
"6/1/2024","","DEBIT","Withdrawal  @ SOUNDCLOUD INC 0 SOUNDCLOUD INC 176-3257837 NY US","-16","","","6.62"
"6/3/2024","","CREDIT","Checking Deposit  @ VENMO*Del Fava Marc 0 VENMO*Del Fava M New York CityNY US","","786","","792.62"
"6/4/2024","","DEBIT","Withdrawal-ACH-A-990166 WEBHomeRiver Group (WEB PMTS)","-755","","","37.62"
"6/5/2024","","DEBIT","Withdrawal-ACH-A-861479 GEICO (PREM COLL)","-52.24","","","-14.62"
"6/5/2024","","CREDIT","Checking Deposit Overdraft transfer from ****190-S0","","0.8","","-13.82"
"6/5/2024","","DEBIT","Withdrawal COURTESY PAY FEE 20.00","-20","","","-33.82"
"6/5/2024","","CREDIT","A Courtesy Payment was made for the amount of 13.82.","","0","","0.0"
"6/6/2024","","CREDIT","Checking Deposit  @ VENMO*Del Fava Marc 0 VENMO*Del Fava M New York CityNY US","","245.63","","211.81"
"6/6/2024","","CREDIT","Checking Deposit  @ VENMO*Del Fava Marc 0 VENMO*Del Fava M New York CityNY US","","206.33","","418.14"
"6/6/2024","","CREDIT","Checking Deposit  @ G1 Online Transfer 'STD' 900.00 from share 0","","900","","1318.14"
"6/6/2024","","DEBIT","Withdrawal  @ VENMO* Marc 0 VENMO* Marc Visa Direct NY US","-800","","","518.14"
"6/6/2024","","DEBIT","Withdrawal  @ CODECADEMY 0 CODECADEMY HTTPSWWW.CODENY US","-149.99","","","368.15"
"6/7/2024","","DEBIT","Withdrawal  @ 809 20TH ST 0 BONFARE MARKET # SACRAMENTO CA US","-4.54","","","363.61"
"6/7/2024","","DEBIT","Withdrawal  @ 809 20TH ST 0 BONFARE MARKET # SACRAMENTO CA US","-54.7","","","308.91"
"6/7/2024","","DEBIT","Withdrawal  @ 5810 FOLSOM BLVD 0 CORTI BROTHERS SACRAMENTO CA US","-70.93","","","237.98"
"6/7/2024","","CREDIT","Checking Deposit Overdraft transfer from ****190-S0","","200","","437.98"
"6/7/2024","","DEBIT","Withdrawal  @ TRENITALIA - LEFREC 0 TRENITALIA - LEF ROMA IT IT","-256.6","","","181.38"
"6/7/2024","","CREDIT","ISA Single-Currency Fee Assessed = 2.54 on 254.06","","0","","0.0"
"6/8/2024","","CREDIT","Checking Deposit  @ CODECADEMY 0 CODECADEMY HTTPSWWW.CODENY US","","149.99","","331.37"
"6/8/2024","","CREDIT","Checking Deposit  @ G1 Online Transfer 'STD' 100.00 from share 0","","100","","431.37"
"6/8/2024","","DEBIT","Withdrawal  @ REI #21 SACRAMENTO 0 REI #21 SACRAMEN SACRAMENTO CA US","-0.82","","","430.55"
"6/8/2024","","DEBIT","Withdrawal  @ NORDSTROM-RACK # 21 0 NORDSTROM-RACK # SACRAMENTO CA US","-64.55","","","366"
"6/8/2024","","DEBIT","Withdrawal  @ SACRAMENTO NATURAL 0 SACRAMENTO NATUR SACRAMENTO CA US","-20.97","","","345.03"
"6/8/2024","","DEBIT","Withdrawal  @ TRENITALIA - PT WL 0 TRENITALIA - PT https://www.tIT IT","-35.02","","","310.01"
"6/8/2024","","CREDIT","ISA Single-Currency Fee Assessed = 0.35 on 34.67","","0","","0.0"
"6/9/2024","","DEBIT","Withdrawal  @ AMAZON PRIME*6C1L64 0 AMAZON PRIME*6C1 888-802-3080 WA US","-3.99","","","306.02"
"6/9/2024","","DEBIT","Withdrawal  @ AMZN Mktp US*3E3JE0 0 AMZN Mktp US*3E3 Amzn.com/billWA US","-8.69","","","297.33"
"6/9/2024","","DEBIT","Withdrawal  @ TST* PETE'S RESTAUR 0 TST* PETE'S REST SACRAMENTO CA US","-27.61","","","269.72"
"6/9/2024","","CREDIT","Checking Deposit  @ G1 Online Transfer 'STD' 100.00 from share 0","","100","","369.72"
"6/9/2024","","DEBIT","Withdrawal  @ 809 20TH ST 0 BONFARE MARKET # SACRAMENTO CA US","-4.99","","","364.73"
"6/10/2024","","DEBIT","Withdrawal  @ PETCO 1343 0 PETCO 1343 SACRAMENTO CA US","-36.18","","","328.55"
"6/10/2024","","DEBIT","Withdrawal  @ TRADER JOE S #17 TR 0 TRADER JOE S #17 SACRAMENTO CA US","-10.9","","","317.65"
"6/10/2024","","DEBIT","Withdrawal  @ Amazon.com*376ZZ5DF 0 Amazon.com*376ZZ Amzn.com/billWA US","-38.89","","","278.76"
"6/11/2024","","DEBIT","Withdrawal-ACH-A-983291 WEBADVS ED SERV WEB (STUDNTLOAN)","-302.16","","","-23.4"
"6/11/2024","","CREDIT","Checking Deposit Overdraft transfer from ****190-S0","","200","","176.6"
"6/11/2024","","DEBIT","Withdrawal  @ ZZOUNDS.COM 0 ZZOUNDS.COM 800-493-3945 NJ US","-49.75","","","126.85"
"6/11/2024","","DEBIT","Withdrawal  @ ATMX031258 2315 J ST CSSI0 EFT Sacramento CA US","-43","","","83.85"
"6/11/2024","","DEBIT","Withdrawal ATM:Fee: ATM FEE DRAFT WITHDRAWAL Trace #144371","-2","","","81.85"
"6/11/2024","","CREDIT","ATM FEE DRAFT WITHDRAWAL Trace #144371 1 @ $2.00","","0","","0.0"
"6/12/2024","","CREDIT","Checking Deposit  @ VENMO*Del Fava Marc 0 VENMO*Del Fava M New York CityNY US","","491.25","","573.1"
"6/13/2024","","DEBIT","Withdrawal  @ ATM92210303 FI APT ARRIVO RIT B CSSI0 524375000023001 FIRENZE IT IT","-90.94","","","482.16"
"6/13/2024","","CREDIT","ISA Single-Currency Fee Assessed = 0.90 on 90.04","","0","","0.0"
"6/13/2024","","DEBIT","Withdrawal  @ GEST SPA 0 GEST SPA SCANDICCI IT IT","-3.73","","","478.43"
"6/13/2024","","CREDIT","ISA Single-Currency Fee Assessed = 0.04 on 3.69","","0","","0.0"
"6/13/2024","","DEBIT","Withdrawal  @ Brezelkonig 0 Brezelkonig Wien-FlughafeAT AT","-23.83","","","454.6"
"6/13/2024","","CREDIT","ISA Single-Currency Fee Assessed = 0.24 on 23.59","","0","","0.0"
"6/13/2024","","DEBIT","Withdrawal ATM:Fee: ATM FEE DRAFT WITHDRAWAL Trace #101402","-2","","","452.6"
"6/13/2024","","CREDIT","ATM FEE DRAFT WITHDRAWAL Trace #101402 1 @ $2.00","","0","","0.0"
"6/13/2024","","DEBIT","Withdrawal  @ AUSTRIAN RETAIL INM 0 AUSTRIAN RETAIL KOELN DE DE","-9.32","","","443.28"
"6/13/2024","","CREDIT","ISA Single-Currency Fee Assessed = 0.09 on 9.23","","0","","0.0"
"6/13/2024","","DEBIT","Withdrawal  @ CVS BY SWYFT 0 CVS BY SWYFT SAN FRANCISCOCA US","-41.76","","","401.52"
"6/13/2024","","DEBIT","Withdrawal  @ CVS BY SWYFT 0 CVS BY SWYFT SAN FRANCISCOCA US","-2.29","","","399.23"
"6/14/2024","","DEBIT","Withdrawal  @ DALEK ONE* SUBSCR 1 0 DALEK ONE* SUBSC HTTPSDALEKONEMN US","-7","","","392.23"
"6/15/2024","","DEBIT","Withdrawal  @ ATM62304712 CA ITALIA CSSI0 0623069871 BAGNONE IT IT","-108.54","","","283.69"
"6/15/2024","","CREDIT","ISA Single-Currency Fee Assessed = 1.07 on 107.47","","0","","0.0"
"6/15/2024","","CREDIT","Checking Deposit  @ TRENITALIA - LEFREC 0 TRENITALIA - LEF ROMA IT IT","","46.08","","329.77"
"6/15/2024","","DEBIT","Withdrawal  @ GEST SPA 0 GEST SPA SCANDICCI IT IT","-3.72","","","326.05"
"6/15/2024","","CREDIT","ISA Single-Currency Fee Assessed = 0.04 on 3.68","","0","","0.0"
"6/15/2024","","DEBIT","Withdrawal ATM:Fee: ATM FEE DRAFT WITHDRAWAL Trace #239104","-2","","","324.05"
"6/15/2024","","CREDIT","ATM FEE DRAFT WITHDRAWAL Trace #239104 1 @ $2.00","","0","","0.0"
"6/16/2024","","DEBIT","Withdrawal  @ ATM62304712 CA ITALIA CSSI0 0623069871 BAGNONE IT IT","-108.54","","","215.51"
"6/16/2024","","CREDIT","ISA Single-Currency Fee Assessed = 1.07 on 107.47","","0","","0.0"
"6/16/2024","","DEBIT","Withdrawal ATM:Fee: ATM FEE DRAFT WITHDRAWAL Trace #726246","-2","","","213.51"
"6/16/2024","","CREDIT","ATM FEE DRAFT WITHDRAWAL Trace #726246 1 @ $2.00","","0","","0.0"
"6/17/2024","","DEBIT","Withdrawal  @ SPLICE.COM* SPLICE 0 SPLICE.COM* SPLI SPLICE.COM NY US","-9.99","","","203.52"
"6/18/2024","","CREDIT","Checking Deposit  @ VENMO*Del Fava Marc 0 VENMO*Del Fava M New York CityNY US","","196.5","","400.02"
"6/19/2024","","DEBIT","Withdrawal  @ ATMNIT0560 Piazza Cappella CSSI0 1616000011 Montepertuso IT IT","-80.4","","","319.62"
"6/19/2024","","CREDIT","ISA Single-Currency Fee Assessed = 0.80 on 79.60","","0","","0.0"
"6/19/2024","","DEBIT","Withdrawal  @ SUMUP *IL CHIOSCO 0 SUMUP *IL CHIOS POSITANO IT IT","-20.11","","","299.51"
"6/19/2024","","CREDIT","ISA Single-Currency Fee Assessed = 0.20 on 19.91","","0","","0.0"
"6/19/2024","","DEBIT","Withdrawal  @ SUMUP *IL CHIOSCO 0 SUMUP *IL CHIOS POSITANO IT IT","-16.31","","","283.2"
"6/19/2024","","CREDIT","ISA Single-Currency Fee Assessed = 0.16 on 16.15","","0","","0.0"
"6/19/2024","","DEBIT","Withdrawal  @ ATMDIT4538 VIA GROTTE DELL INC CSSI0 1616000011 POSITANO IT IT","-58.6","","","224.6"
"6/19/2024","","CREDIT","ISA Single-Currency Fee Assessed = 0.58 on 58.02","","0","","0.0"
"6/19/2024","","DEBIT","Withdrawal  @ SPOTIFY 0 SPOTIFY 877-778-1161 NY US","-10.99","","","213.61"
"6/19/2024","","DEBIT","Withdrawal ATM:Fee: ATM FEE DRAFT WITHDRAWAL Trace #577618","-2","","","211.61"
"6/19/2024","","CREDIT","ATM FEE DRAFT WITHDRAWAL Trace #577618 1 @ $2.00","","0","","0.0"
"6/19/2024","","DEBIT","Withdrawal ATM:Fee: ATM FEE DRAFT WITHDRAWAL Trace #811916","-2","","","209.61"
"6/19/2024","","CREDIT","ATM FEE DRAFT WITHDRAWAL Trace #811916 1 @ $2.00","","0","","0.0"
"6/20/2024","","DEBIT","Withdrawal  @ ATMNIT4307 RAMPA TEGLIA 21 CSSI0 1616000011 POSITANO IT IT","-80.33","","","129.28"
"6/20/2024","","CREDIT","ISA Single-Currency Fee Assessed = 0.80 on 79.53","","0","","0.0"
"6/20/2024","","DEBIT","Withdrawal ATM:Fee: ATM FEE DRAFT WITHDRAWAL Trace #940837","-2","","","127.28"
"6/20/2024","","CREDIT","ATM FEE DRAFT WITHDRAWAL Trace #940837 1 @ $2.00","","0","","0.0"
"6/20/2024","","DEBIT","Withdrawal  @ BUCA DI BACCO POSIT 0 BUCA DI BACCO PO POSITANO IT IT","-18.46","","","108.82"
"6/20/2024","","CREDIT","ISA Single-Currency Fee Assessed = 0.18 on 18.28","","0","","0.0"
"6/20/2024","","DEBIT","Withdrawal  @ AGRITURISMO S.ALFON 0 AGRITURISMO S.AL FURORE IT IT","-16.29","","","92.53"
"6/20/2024","","CREDIT","ISA Single-Currency Fee Assessed = 0.16 on 16.13","","0","","0.0"
"6/21/2024","","DEBIT","Withdrawal  @ ATM1724 ICCREA ATM 80001724 CSSI0 ICCREA 08000 IT IT","-113.61","","","-21.08"
"6/21/2024","","CREDIT","ISA Single-Currency Fee Assessed = 1.12 on 112.49","","0","","0.0"
"6/21/2024","","CREDIT","Checking Deposit Overdraft transfer from ****190-S0","","200","","178.92"
"6/21/2024","","DEBIT","Withdrawal  @ PADDLE.NET* KAIBER 0 PADDLE.NET* KAIB PADDLE.COM NY US","-15","","","163.92"
"6/21/2024","","DEBIT","Withdrawal ATM:Fee: ATM FEE DRAFT WITHDRAWAL Trace #373243","-2","","","161.92"
"6/21/2024","","CREDIT","ATM FEE DRAFT WITHDRAWAL Trace #373243 1 @ $2.00","","0","","0.0"
"6/22/2024","","CREDIT","Checking Deposit  @ G1 Online Transfer 'STD' 500.00 from share 0","","500","","661.92"
"6/22/2024","","DEBIT","Withdrawal  @ TRAINLINE 0 TRAINLINE UNKNOWN FR FR","-86.43","","","575.49"
"6/22/2024","","CREDIT","ISA Single-Currency Fee Assessed = 0.86 on 85.57","","0","","0.0"
"6/22/2024","","DEBIT","Withdrawal  @ ATM97895610 VIALE EUROPA 13 CSSI0 INTESASPAO95610 CASTELLAMMANAIT IT","-382.31","","","193.18"
"6/22/2024","","CREDIT","ISA Single-Currency Fee Assessed = 3.79 on 378.52","","0","","0.0"
"6/22/2024","","DEBIT","Withdrawal ATM:Fee: ATM FEE DRAFT WITHDRAWAL Trace #167219","-2","","","191.18"
"6/22/2024","","CREDIT","ATM FEE DRAFT WITHDRAWAL Trace #167219 1 @ $2.00","","0","","0.0"
"6/22/2024","","DEBIT","Withdrawal  @ TRENITALIA - PT WL 0 TRENITALIA - PT https://www.tIT IT","-30.32","","","160.86"
"6/22/2024","","CREDIT","ISA Single-Currency Fee Assessed = 0.30 on 30.02","","0","","0.0"
"6/22/2024","","DEBIT","Withdrawal  @ AGRITURISMO S.ALFON 0 AGRITURISMO S.AL FURORE IT IT","-21.66","","","139.2"
"6/22/2024","","CREDIT","ISA Single-Currency Fee Assessed = 0.21 on 21.45","","0","","0.0"
"6/23/2024","","DEBIT","Withdrawal  @ AGRITURISMO S.ALFON 0 AGRITURISMO S.AL FURORE IT IT","-43.32","","","95.88"
"6/23/2024","","CREDIT","ISA Single-Currency Fee Assessed = 0.43 on 42.89","","0","","0.0"
"6/23/2024","","DEBIT","Withdrawal  @ NETFLIX.COM 0 NETFLIX.COM LOS GATOS CA US","-15.49","","","80.39"
"6/23/2024","","DEBIT","Withdrawal  @ UBER *TRIP 0 UBER *TRIP HELP.UBER.COMNL NL","-33","","","47.39"
"6/23/2024","","CREDIT","ISA Single-Currency Fee Assessed = 0.33 on 32.67","","0","","0.0"
"6/23/2024","","DEBIT","Withdrawal  @ UBER *TRIP 0 UBER *TRIP HELP.UBER.COMNL NL","-1.08","","","46.31"
"6/23/2024","","CREDIT","ISA Single-Currency Fee Assessed = 0.01 on 1.07","","0","","0.0"
"6/23/2024","","DEBIT","Withdrawal  @ ACQU.DISTRIB.AUTOMA 0 ACQU.DISTRIB.AUT SERIATE IT IT","-1.52","","","44.79"
"6/23/2024","","CREDIT","ISA Single-Currency Fee Assessed = 0.02 on 1.50","","0","","0.0"
"6/23/2024","","DEBIT","Withdrawal  @ ACQU.DISTRIB.AUTOMA 0 ACQU.DISTRIB.AUT SERIATE IT IT","-1.63","","","43.16"
"6/23/2024","","CREDIT","ISA Single-Currency Fee Assessed = 0.02 on 1.61","","0","","0.0"
"6/23/2024","","DEBIT","Withdrawal  @ ACQU.DISTRIB.AUTOMA 0 ACQU.DISTRIB.AUT SERIATE IT IT","-1.63","","","41.53"
"6/23/2024","","CREDIT","ISA Single-Currency Fee Assessed = 0.02 on 1.61","","0","","0.0"
"6/23/2024","","DEBIT","Withdrawal  @ EUROCONCA DI MILO C 0 EUROCONCA DI MIL CONCA DEI MARIT IT","-11.37","","","30.16"
"6/23/2024","","CREDIT","ISA Single-Currency Fee Assessed = 0.11 on 11.26","","0","","0.0"
"6/24/2024","","DEBIT","Withdrawal  @ ATMNNL0239 EERSTE HELMERSSTRAA CSSI0 1528000001 Amsterdam NL NL","-80.09","","","-49.93"
"6/24/2024","","CREDIT","ISA Single-Currency Fee Assessed = 0.79 on 79.30","","0","","0.0"
"6/24/2024","","CREDIT","Checking Deposit Overdraft transfer from ****190-S0","","200","","150.07"
"6/24/2024","","CREDIT","Checking Deposit  @ G1 Online Transfer 'STD' 100.00 from share 0","","100","","250.07"
"6/24/2024","","DEBIT","Withdrawal  @ VJFB Staringplein B 0 VJFB Staringplei Amsterdam NL NL","-48.72","","","201.35"
"6/24/2024","","CREDIT","ISA Single-Currency Fee Assessed = 0.48 on 48.24","","0","","0.0"
"6/24/2024","","DEBIT","Withdrawal  @ Caffe Oslo 0 Caffe Oslo Amsterdam NL NL","-34.99","","","166.36"
"6/24/2024","","CREDIT","ISA Single-Currency Fee Assessed = 0.35 on 34.64","","0","","0.0"
"6/24/2024","","DEBIT","Withdrawal  @ DE PRIJS 0 DE PRIJS AMSTERDAM NL NL","-25.45","","","140.91"
"6/24/2024","","CREDIT","ISA Single-Currency Fee Assessed = 0.25 on 25.20","","0","","0.0"
"6/24/2024","","DEBIT","Withdrawal  @ STACH JP Heijestraa 0 STACH JP Heijest AMSTERDAM NL NL","-16.03","","","124.88"
"6/24/2024","","CREDIT","ISA Single-Currency Fee Assessed = 0.16 on 15.87","","0","","0.0"
"6/24/2024","","DEBIT","Withdrawal ATM:Fee: ATM FEE DRAFT WITHDRAWAL Trace #222677","-2","","","122.88"
"6/24/2024","","CREDIT","ATM FEE DRAFT WITHDRAWAL Trace #222677 1 @ $2.00","","0","","0.0"
"6/24/2024","","DEBIT","Withdrawal  @ FLOWCHART FUN PRO 0 FLOWCHART FUN PR HTTPSFLOWCHARNC US","-3","","","119.88"
"6/25/2024","","CREDIT","Checking Deposit  @ VENMO*Del Fava Marc 0 VENMO*Del Fava M New York CityNY US","","196.5","","316.38"
"6/25/2024","","DEBIT","Withdrawal  @ AMSTERDAM GVB 0 AMSTERDAM GVB AMSTERDAM NL NL","-45.49","","","270.89"
"6/25/2024","","CREDIT","ISA Single-Currency Fee Assessed = 0.45 on 45.04","","0","","0.0"
"6/25/2024","","DEBIT","Withdrawal  @ STARING APOTHEEK V. 0 STARING APOTHEEK AMSTERDAM NL NL","-22.24","","","248.65"
"6/25/2024","","CREDIT","ISA Single-Currency Fee Assessed = 0.22 on 22.02","","0","","0.0"
"6/25/2024","","DEBIT","Withdrawal  @ Caffe Oslo 0 Caffe Oslo Amsterdam NL NL","-12.05","","","236.6"
"6/25/2024","","CREDIT","ISA Single-Currency Fee Assessed = 0.12 on 11.93","","0","","0.0"
"6/25/2024","","DEBIT","Withdrawal  @ Get Down 0 Get Down Amsterdam NL NL","-5.42","","","231.18"
"6/25/2024","","CREDIT","ISA Single-Currency Fee Assessed = 0.05 on 5.37","","0","","0.0"
"6/25/2024","","DEBIT","Withdrawal  @ Nl123 Flying Tiger 0 Nl123 Flying Tig Rotterdam NL NL","-15.2","","","215.98"
"6/25/2024","","CREDIT","ISA Single-Currency Fee Assessed = 0.15 on 15.05","","0","","0.0"
"6/25/2024","","DEBIT","Withdrawal  @ The Bulldog Palace 0 The Bulldog Pala Amsterdam NL NL","-13.57","","","202.41"
"6/25/2024","","CREDIT","ISA Single-Currency Fee Assessed = 0.13 on 13.44","","0","","0.0"
"6/25/2024","","DEBIT","Withdrawal  @ Nl123 Flying Tiger 0 Nl123 Flying Tig Rotterdam NL NL","-40.71","","","161.7"
"6/25/2024","","CREDIT","ISA Single-Currency Fee Assessed = 0.40 on 40.31","","0","","0.0"
"6/25/2024","","DEBIT","Withdrawal  @ JUMBO AMSTERDAM BAA 0 JUMBO AMSTERDAM AMSTERDAM NL NL","-56.51","","","105.19"
"6/25/2024","","CREDIT","ISA Single-Currency Fee Assessed = 0.56 on 55.95","","0","","0.0"
"6/25/2024","","DEBIT","Withdrawal  @ JUMBO AMSTERDAM BAA 0 JUMBO AMSTERDAM AMSTERDAM NL NL","-13.96","","","91.23"
"6/25/2024","","CREDIT","ISA Single-Currency Fee Assessed = 0.14 on 13.82","","0","","0.0"
"6/25/2024","","DEBIT","Withdrawal  @ CLAYTON AMSTERDAM A 0 CLAYTON AMSTERDA AMSTERDAM NL NL","-6.79","","","84.44"
"6/25/2024","","CREDIT","ISA Single-Currency Fee Assessed = 0.07 on 6.72","","0","","0.0"
"6/26/2024","","DEBIT","Withdrawal  @ ALBERT HEIJN 5614 0 ALBERT HEIJN 561 AMSTERDAM NL NL","-8.52","","","75.92"
"6/26/2024","","CREDIT","ISA Single-Currency Fee Assessed = 0.08 on 8.44","","0","","0.0"
"6/26/2024","","CREDIT","Checking Deposit Overdraft transfer from ****190-S0","","200","","275.92"
"6/26/2024","","DEBIT","Withdrawal  @ JUMBO AMSTERDAM BAA 0 JUMBO AMSTERDAM AMSTERDAM NL NL","-30.59","","","245.33"
"6/26/2024","","CREDIT","ISA Single-Currency Fee Assessed = 0.30 on 30.29","","0","","0.0"
"6/26/2024","","DEBIT","Withdrawal  @ CROISSANTERIE OUTMA 0 CROISSANTERIE OU Amsterdam NL NL","-13.51","","","231.82"
"6/26/2024","","CREDIT","ISA Single-Currency Fee Assessed = 0.13 on 13.38","","0","","0.0"
"6/26/2024","","DEBIT","Withdrawal  @ Caffe Oslo 0 Caffe Oslo Amsterdam NL NL","-7.71","","","224.11"
"6/26/2024","","CREDIT","ISA Single-Currency Fee Assessed = 0.08 on 7.63","","0","","0.0"
"6/26/2024","","DEBIT","Withdrawal  @ Pizza Pasta Bar 0 Pizza Pasta Bar Amsterdam NL NL","-30.94","","","193.17"
"6/26/2024","","CREDIT","ISA Single-Currency Fee Assessed = 0.31 on 30.63","","0","","0.0"
"6/26/2024","","CREDIT","Checking Deposit  @ G1 Online Transfer 'STD' 800.00 from share 0","","800","","993.17"
"6/27/2024","","DEBIT","Withdrawal  @ APPLE.COM/BILL 0 APPLE.COM/BILL 866-712-7753 CA US","-13.98","","","979.19"
"6/27/2024","","DEBIT","Withdrawal  @ Proeflokaal De Mole 0 Proeflokaal De M Amsterdam NL NL","-7.52","","","971.67"
"6/27/2024","","CREDIT","ISA Single-Currency Fee Assessed = 0.07 on 7.45","","0","","0.0"
"6/27/2024","","DEBIT","Withdrawal  @ Proeflokaal De Mole 0 Proeflokaal De M Amsterdam NL NL","-24.25","","","947.42"
"6/27/2024","","CREDIT","ISA Single-Currency Fee Assessed = 0.24 on 24.01","","0","","0.0"
"6/27/2024","","DEBIT","Withdrawal  @ The Tire Station BV 0 The Tire Station Amsterdam NL NL","-173.93","","","773.49"
"6/27/2024","","CREDIT","ISA Single-Currency Fee Assessed = 1.72 on 172.21","","0","","0.0"
"6/27/2024","","DEBIT","Withdrawal  @ GVB voertuig T2045C 0 GVB voertuig T20 AMSTERDAM NL NL","-7.36","","","766.13"
"6/27/2024","","CREDIT","ISA Single-Currency Fee Assessed = 0.07 on 7.29","","0","","0.0"
"6/27/2024","","DEBIT","Withdrawal  @ GVB voertuig T2051C 0 GVB voertuig T20 AMSTERDAM NL NL","-7.36","","","758.77"
"6/27/2024","","CREDIT","ISA Single-Currency Fee Assessed = 0.07 on 7.29","","0","","0.0"
"6/27/2024","","DEBIT","Withdrawal  @ Groot Melkhuis BV. 0 Groot Melkhuis B 0206129674 NL NL","-9.65","","","749.12"
"6/27/2024","","CREDIT","ISA Single-Currency Fee Assessed = 0.10 on 9.55","","0","","0.0"
"6/27/2024","","DEBIT","Withdrawal  @ Conscious Hotel 0 Conscious Hotel Amsterdam NL NL","-2.71","","","746.41"
"6/27/2024","","CREDIT","ISA Single-Currency Fee Assessed = 0.03 on 2.68","","0","","0.0"
"6/27/2024","","DEBIT","Withdrawal  @ Conscious Hotel 0 Conscious Hotel Amsterdam NL NL","-8.67","","","737.74"
"6/27/2024","","CREDIT","ISA Single-Currency Fee Assessed = 0.09 on 8.58","","0","","0.0"
"6/27/2024","","DEBIT","Withdrawal  @ DE PRIJS 0 DE PRIJS AMSTERDAM NL NL","-6.49","","","731.25"
"6/27/2024","","CREDIT","ISA Single-Currency Fee Assessed = 0.06 on 6.43","","0","","0.0"
"6/28/2024","","DEBIT","Withdrawal-ACH-A-990166 WEBHomeRiver Group (WEB PMTS)","-755","","","-23.75"
"6/28/2024","","CREDIT","Checking Deposit Overdraft transfer from ****190-S0","","200","","176.25"
"6/28/2024","","DEBIT","Withdrawal  @ BART-CLIPPER SFIA 0 BART-CLIPPER SFI SAN FRANCISCOCA US","-20","","","156.25"
"6/28/2024","","DEBIT","Withdrawal  @ UBER *TRIP 0 UBER *TRIP HELP.UBER.COMNL NL","-26.95","","","129.3"
"6/28/2024","","CREDIT","ISA Single-Currency Fee Assessed = 0.27 on 26.68","","0","","0.0"
"6/28/2024","","DEBIT","Withdrawal  @ Conscious Hotel 0 Conscious Hotel Amsterdam NL NL","-8.13","","","121.17"
"6/28/2024","","CREDIT","ISA Single-Currency Fee Assessed = 0.08 on 8.05","","0","","0.0"
"6/28/2024","","DEBIT","Withdrawal  @ Caffe Oslo 0 Caffe Oslo Amsterdam NL NL","-38.15","","","83.02"
"6/28/2024","","CREDIT","ISA Single-Currency Fee Assessed = 0.38 on 37.77","","0","","0.0"
"6/28/2024","","DEBIT","Withdrawal  @ AMSTERDAM GVB 0 AMSTERDAM GVB AMSTERDAM NL NL","-7.36","","","75.66"
"6/28/2024","","CREDIT","ISA Single-Currency Fee Assessed = 0.07 on 7.29","","0","","0.0"
"6/29/2024","","DEBIT","Withdrawal  @ NUGGET MARKET #6 0 NUGGET MARKET #6 WEST SACRAMENCA US","-9.71","","","65.95"
"6/29/2024","","DEBIT","Withdrawal  @ 5810 FOLSOM BLVD 0 CORTI BROTHERS SACRAMENTO CA US","-12.47","","","53.48"
"6/29/2024","","DEBIT","Withdrawal  @ APPLE.COM/BILL 0 APPLE.COM/BILL 866-712-7753 CA US","-12.99","","","40.49"
"6/29/2024","","DEBIT","Withdrawal  @ VOCLR.IT 0 VOCLR.IT SALISBURY GB GB","-10.09","","","30.4"
"6/29/2024","","CREDIT","ISA Single-Currency Fee Assessed = 0.10 on 9.99 - Recurring or Installment payment","","0","","0.0"
"7/1/2024","","DEBIT","Withdrawal-ACH-A-1096016 ATT (Payment)","-79.99","","","-49.59"
"7/1/2024","","CREDIT","Checking Deposit Overdraft transfer from ****190-S0","","74.6","","25.01"
"7/1/2024","","CREDIT","A Courtesy Payment was made for the amount of 5.39.","","0","","0.0"
"7/1/2024","","DEBIT","Withdrawal  @ GOOGLE *GSUITE bark 0 GOOGLE *GSUITE b cc@google.comCA US","-26.4","","","-1.39"
"7/1/2024","","CREDIT","A Courtesy Payment was made for the amount of 26.40.","","0","","0.0"
"7/1/2024","","DEBIT","Withdrawal  @ SAFEWAY #2242 0 SAFEWAY #2242 SACRAMENTO CA US","-10.86","","","-12.25"
"7/1/2024","","DEBIT","Withdrawal  @ SAFEWAY #2242 0 SAFEWAY #2242 SACRAMENTO CA US","-12.98","","","-25.23"
"7/1/2024","","DEBIT","Withdrawal  @ EMBRACE PET INSURAN 0 EMBRACE PET INSU HELLO@EMBRACEOH US","-17.89","","","-43.12"
"7/1/2024","","CREDIT","A Courtesy Payment was made for the amount of 13.66.","","0","","0.0"
"7/1/2024","","DEBIT","Withdrawal  @ APPLE.COM/BILL 0 APPLE.COM/BILL 866-712-7753 CA US","-2.99","","","-46.11"
"7/1/2024","","CREDIT","A Courtesy Payment was made for the amount of 2.99.","","0","","0.0"
"7/5/2024","","DEBIT","Withdrawal-ACH-A-861479 GEICO (PREM COLL)","-52.23","","","-98.34"
"7/5/2024","","DEBIT","Withdrawal COURTESY PAY FEE 20.00","-20","","","-118.34"
"7/5/2024","","CREDIT","A Courtesy Payment was made for the amount of 52.23.","","0","","0.0"
"7/20/2024","","DEBIT","Withdrawal  @ SOUNDCLOUD INC 0 SOUNDCLOUD INC 176-3257837 NY US","-16","","","-134.34"
"7/20/2024","","CREDIT","Checking Deposit Overdraft transfer from ****190-S0","","200","","65.66"
"7/20/2024","","DEBIT","Withdrawal  @ SPLICE.COM* SPLICE 0 SPLICE.COM* SPLI SPLICE.COM NY US","-9.99","","","55.67"
"7/20/2024","","DEBIT","Withdrawal  @ Spotify USA 0 Spotify USA 877-7781161 NY US","-11.99","","","43.68"
"7/20/2024","","DEBIT","Withdrawal  @ DALEK ONE* SUBSCR 1 0 DALEK ONE* SUBSC HTTPSDALEKONEMN US","-7","","","36.68"
"7/21/2024","","DEBIT","Withdrawal  @ LYFT *RIDE SAT 8P 0 LYFT *RIDE SAT LYFT.COM CA US","-7.35","","","29.33"
"7/21/2024","","CREDIT","Checking Deposit Overdraft transfer from ****190-S0","","200","","229.33"
"7/21/2024","","DEBIT","Withdrawal  @ Amazon Prime*RJ7P33 0 Amazon Prime*RJ7 Amzn.com/billWA US","-8.15","","","221.18"
"7/21/2024","","DEBIT","Withdrawal  @ PADDLE.NET* KAIBER 0 PADDLE.NET* KAIB PADDLE.COM NY US","-15","","","206.18"
"7/21/2024","","DEBIT","Withdrawal  @ SACRAMENTO NATURAL 0 SACRAMENTO NATUR SACRAMENTO CA US","-88.25","","","117.93"
"7/21/2024","","CREDIT","Checking Deposit  @ G1 Online Transfer 315.00 from LV 1","","315","","432.93"
"7/21/2024","","DEBIT","Withdrawal  @ VENMO* Marc 0 VENMO* Marc Visa Direct NY US","-315","","","117.93"
"7/21/2024","","DEBIT","Withdrawal  @ ATMDNS39935 5401 H ST 2 CSSI0 LA GARE SACRAMENTO CA US","-33.5","","","84.43"
"7/21/2024","","CREDIT","Checking Deposit Overdraft transfer from ****190-S0","","200","","284.43"
"7/21/2024","","DEBIT","Withdrawal ATM:Fee: ATM FEE DRAFT WITHDRAWAL Trace #51300006441","-2","","","282.43"
"7/21/2024","","CREDIT","ATM FEE DRAFT WITHDRAWAL Trace #51300006441 1 @ $2.00","","0","","0.0"
"7/22/2024","","DEBIT","Withdrawal  @ LYFT *RIDE SAT 11 0 LYFT *RIDE SAT LYFT.COM CA US","-8.47","","","273.96"
"7/22/2024","","DEBIT","Withdrawal  @ APPLE CASH SENT MON 0 APPLE CASH SENT 1INFINITELOOPCA US","-29.93","","","244.03"
"7/22/2024","","DEBIT","Withdrawal  @ ZZOUNDS.COM 0 ZZOUNDS.COM 800-493-3945 NJ US","-49.75","","","194.28"
"7/22/2024","","DEBIT","Withdrawal  @ APPLE.COM/BILL 0 APPLE.COM/BILL 866-712-7753 CA US","-13.99","","","180.29"
"7/23/2024","","DEBIT","Withdrawal  @ NETFLIX.COM 0 NETFLIX.COM LOS GATOS CA US","-15.49","","","164.8"
"7/24/2024","","DEBIT","Withdrawal  @ FLOWCHART FUN PRO 0 FLOWCHART FUN PR HTTPSFLOWCHARNC US","-3","","","161.8"
"7/26/2024","","DEBIT","Withdrawal  @ EB OVER YONDER 0 EB OVER YONDER 8014137200 CA US","-28.52","","","133.28"
"7/27/2024","","DEBIT","Withdrawal  @ SAFEWAY #1127 0 SAFEWAY #1127 FAIRFIELD CA US","-23.09","","","110.19"
"7/28/2024","","DEBIT","Withdrawal  @ SHELL OIL 574430170 0 SHELL OIL 574430 SACRAMENTO CA US","-20.02","","","90.17"
"7/28/2024","","DEBIT","Withdrawal  @ TRADER JOE S #17 TR 0 TRADER JOE S #17 SACRAMENTO CA US","-69.09","","","21.08"
"7/29/2024","","DEBIT","Withdrawal  @ APPLE CASH SENT MON 0 APPLE CASH SENT 1INFINITELOOPCA US","-5","","","16.08"
"7/29/2024","","DEBIT","Withdrawal-ACH-A-1096016 ATT (Payment)","-84.99","","","-68.91"
"7/29/2024","","CREDIT","Checking Deposit Overdraft transfer from ****190-S0","","200","","131.09"
"7/29/2024","","DEBIT","Withdrawal  @ LINDA S TAQUERIA 0 LINDA S TAQUERIA 916-4471707 CA US","-19.62","","","111.47"
"7/29/2024","","DEBIT","Withdrawal  @ VOCLR.IT 0 VOCLR.IT SALISBURY GB GB","-10.09","","","101.38"
"7/29/2024","","CREDIT","ISA Single-Currency Fee Assessed = 0.10 on 9.99 - Recurring or Installment payment","","0","","0.0"
"7/30/2024","","DEBIT","Withdrawal  @ APPLE.COM/BILL 0 APPLE.COM/BILL 866-712-7753 CA US","-12.99","","","88.39"
"7/30/2024","","DEBIT","Withdrawal  @ ATMX031258 2315 J ST CSSI0 EFT Sacramento CA US","-43","","","45.39"
"7/30/2024","","DEBIT","Withdrawal ATM:Fee: ATM FEE DRAFT WITHDRAWAL Trace #141230","-2","","","43.39"
"7/30/2024","","CREDIT","ATM FEE DRAFT WITHDRAWAL Trace #141230 1 @ $2.00","","0","","0.0"
"7/31/2024","","DEBIT","Withdrawal  @ EMBRACE PET INSURAN 0 EMBRACE PET INSU HELLO@EMBRACEOH US","-17.89","","","25.5"
"8/1/2024","","DEBIT","Withdrawal  @ LOVE LAUNDRY 0 LOVE LAUNDRY SACRAMENTO CA US","-19.5","","","6"
"8/1/2024","","CREDIT","Checking Deposit Overdraft transfer from ****190-S0","","200","","206"
"8/1/2024","","DEBIT","Withdrawal  @ GOOGLE GSUITE bark 0 GOOGLE GSUITE b 650-2530000 CA US","-14.4","","","191.6"
"8/1/2024","","DEBIT","Withdrawal  @ APPLE.COM/BILL 0 APPLE.COM/BILL 866-712-7753 CA US","-2.99","","","188.61"
"8/1/2024","","DEBIT","Withdrawal  @ CITYOFSAC IPS PKGME 0 CITYOFSAC IPS PK SACRAMENTO CA US","-2","","","186.61"
"8/1/2024","","DEBIT","Withdrawal  @ SAFEWAY #2242 0 SAFEWAY #2242 SACRAMENTO CA US","-42.91","","","143.7"
"8/1/2024","","DEBIT","Withdrawal  @ SOUNDCLOUD INC 0 SOUNDCLOUD INC 176-3257837 NY US","-16","","","127.7"
"8/2/2024","","DEBIT","Withdrawal  @ SHELL SERVICE STATI 0 SHELL SERVICE ST SACRAMENTO CA US","-21.99","","","105.71"
"8/2/2024","","DEBIT","Withdrawal  @ 5810 FOLSOM BLVD 0 CORTI BROTHERS SACRAMENTO CA US","-33.8","","","71.91"
"8/2/2024","","DEBIT","Withdrawal  @ PETCO 1343 0 PETCO 1343 SACRAMENTO CA US","-32.59","","","39.32"
"8/3/2024","","DEBIT","Withdrawal  @ AMAZON MKTPL*RF7613 0 AMAZON MKTPL*RF7 Amzn.com/billWA US","-15.65","","","23.67"
"8/3/2024","","DEBIT","Withdrawal  @ AMAZON MKTPL*RF5TD7 0 AMAZON MKTPL*RF5 Amzn.com/billWA US","-7.6","","","16.07"
"8/3/2024","","DEBIT","Withdrawal  @ SQ *TEMPLE COFFEE K 0 SQ *TEMPLE COFFE Sacramento CA US","-15.47","","","0.6"
"8/3/2024","","CREDIT","Checking Deposit Overdraft transfer from ****190-S0","","200","","200.6"
"8/4/2024","","DEBIT","Withdrawal  @ BONFARE MARKET #33 0 BONFARE MARKET # SACRAMENTO CA US","-5.54","","","195.06"
"8/4/2024","","DEBIT","Withdrawal  @ ATMX031258 2315 J ST CSSI0 EFT Sacramento CA US","-23","","","172.06"
"8/4/2024","","DEBIT","Withdrawal  @ SQ *TEMPLE COFFEE K 0 SQ *TEMPLE COFFE Sacramento CA US","-6.2","","","165.86"
"8/4/2024","","DEBIT","Withdrawal  @ AMAZON MKTPL*RF3059 0 AMAZON MKTPL*RF3 Amzn.com/billWA US","-9.78","","","156.08"
"8/4/2024","","DEBIT","Withdrawal ATM:Fee: ATM FEE DRAFT WITHDRAWAL Trace #198935","-2","","","154.08"
"8/4/2024","","CREDIT","ATM FEE DRAFT WITHDRAWAL Trace #198935 1 @ $2.00","","0","","0.0"
"8/5/2024","","DEBIT","Withdrawal  @ BONFARE MARKET #33 0 BONFARE MARKET # SACRAMENTO CA US","-16.63","","","137.45"
"8/5/2024","","DEBIT","Withdrawal  @ BONFARE MARKET #33 0 BONFARE MARKET # SACRAMENTO CA US","-4.99","","","132.46"
"8/5/2024","","DEBIT","Withdrawal-ACH-A-990166 WEBHomeRiver Group (WEB PMTS)","-755","","","-622.54"
"8/5/2024","","CREDIT","Checking Deposit Overdraft transfer from ****190-S0","","166.47","","-456.07"
"8/5/2024","","DEBIT","Withdrawal COURTESY PAY FEE 20.00","-20","","","-476.07"
"8/5/2024","","CREDIT","A Courtesy Payment was made for the amount of 456.07.","","0","","0.0"
"8/5/2024","","CREDIT","ACH Returns: GEICO (PREM COLL)  57.41 NSF| Balance=$-476.07. Available Balance=$0.00. Available Balance with ODP=$0.00.","","0","","0.0"
"8/7/2024","","CREDIT","Checking Deposit  @ G1 Online Transfer 'STD' 500.00 from share 0","","500","","23.93"
"8/7/2024","","DEBIT","Withdrawal  @ SACRAMENTO NATURAL 0 SACRAMENTO NATUR SACRAMENTO CA US","-10.1","","","13.83"
"8/7/2024","","CREDIT","Checking Deposit Overdraft transfer from ****190-S0","","200","","213.83"
"8/7/2024","","DEBIT","Withdrawal  @ SQ *TEMPLE COFFEE K 0 SQ *TEMPLE COFFE Sacramento CA US","-6.2","","","207.63"
"8/7/2024","","DEBIT","Withdrawal  @ SACRAMENTO NATURAL 0 SACRAMENTO NATUR SACRAMENTO CA US","-166.92","","","40.71"
"8/7/2024","","CREDIT","Checking Deposit Overdraft transfer from ****190-S0","","200","","240.71"
"8/7/2024","","DEBIT","Withdrawal  @ 809 20TH ST 0 BONFARE MARKET # SACRAMENTO CA US","-4.99","","","235.72"
"8/7/2024","","DEBIT","Withdrawal  @ Broadcast Music Inc 0 Broadcast Music 800-4012000 TN US","-75","","","160.72"
"8/8/2024","","DEBIT","Withdrawal  @ AMAZON RETA* RM5PH0 0 AMAZON RETA* RM5 WWW.AMAZON.COWA US","-38.89","","","121.83"
"8/8/2024","","DEBIT","Withdrawal  @ ATMX031258 2315 J ST CSSI0 EFT Sacramento CA US","-43","","","78.83"
"8/8/2024","","DEBIT","Withdrawal  @ 5810 FOLSOM BLVD 0 CORTI BROTHERS SACRAMENTO CA US","-28.54","","","50.29"
"8/8/2024","","DEBIT","Withdrawal ATM:Fee: ATM FEE DRAFT WITHDRAWAL Trace #198321","-2","","","48.29"
"8/8/2024","","CREDIT","ATM FEE DRAFT WITHDRAWAL Trace #198321 1 @ $2.00","","0","","0.0"
"8/8/2024","","DEBIT","Withdrawal  @ PADDLE.NET* KAIBER 0 PADDLE.NET* KAIB PADDLE.COM NY US","-15","","","33.29"
"8/9/2024","","DEBIT","Withdrawal-ACH-A-861479 GEICO (RETRY PYMT)","-57.41","","","-24.12"
"8/9/2024","","CREDIT","Checking Deposit Overdraft transfer from ****190-S0","","200","","175.88"
"8/9/2024","","DEBIT","Withdrawal  @ ARCO#83191J STREET 0 ARCO#83191J STRE SACRAMENTO CA US","-13.67","","","162.21"
"8/9/2024","","DEBIT","Withdrawal  @ SQ *TEMPLE COFFEE K 0 SQ *TEMPLE COFFE Sacramento CA US","-13.17","","","149.04"
"8/9/2024","","DEBIT","Withdrawal  @ 809 20TH ST 0 BONFARE MARKET # SACRAMENTO CA US","-15.54","","","133.5"
"8/9/2024","","DEBIT","Withdrawal  @ SAIGON CORNER 0 SAIGON CORNER SACRAMENTO CA US","-16.62","","","116.88"
"8/10/2024","","DEBIT","Withdrawal  @ BONFARE MARKET #33 0 BONFARE MARKET # SACRAMENTO CA US","-7.71","","","109.17"
"8/10/2024","","DEBIT","Withdrawal  @ AZUL MEXICAN FOOD & 0 AZUL MEXICAN FOO SACRAMENTO CA US","-12.8","","","96.37"
"8/10/2024","","DEBIT","Withdrawal  @ Prime Video *RM60N0 0 Prime Video *RM6 888-802-3080 WA US","-3.79","","","92.58"
"8/11/2024","","DEBIT","Withdrawal  @ COSTCO WHSE #0471 0 COSTCO WHSE #047 SACRAMENTO CA US","-105.87","","","-13.29"
"8/11/2024","","CREDIT","Checking Deposit Overdraft transfer from ****190-S0","","200","","186.71"
"8/11/2024","","DEBIT","Withdrawal  @ SACRAMENTO NATURAL 0 SACRAMENTO NATUR SACRAMENTO CA US","-57.07","","","129.64"
"8/11/2024","","DEBIT","Withdrawal  @ SQ *PACHAMAMA COFFE 0 SQ *PACHAMAMA CO Sacramento CA US","-5.12","","","124.52"
"8/12/2024","","DEBIT","Withdrawal  @ ZZOUNDS.COM 0 ZZOUNDS.COM 800-493-3945 NJ US","-49.75","","","74.77"
"8/12/2024","","DEBIT","Withdrawal  @ ORBIT WASH 0 ORBIT WASH SACRAMENTO CA US","-9.75","","","65.02"
"8/12/2024","","DEBIT","Withdrawal  @ SAFEWAY #2242 0 SAFEWAY #2242 SACRAMENTO CA US","-32.72","","","32.3"
"8/13/2024","","DEBIT","Withdrawal  @ DUTCH BROS CA1912 0 DUTCH BROS CA191 SACRAMENTO CA US","-5.95","","","26.35"
"8/13/2024","","DEBIT","Withdrawal  @ AUNTIE ANNES CA258 0 AUNTIE ANNES CA2 SACRAMENTO CA US","-8.28","","","18.07"
"8/13/2024","","DEBIT","Withdrawal  @ LA SUPERIOR SUPE 22 0 LA SUPERIOR SUPE SACRAMENTO CA US","-15.45","","","2.62"
"8/13/2024","","CREDIT","Checking Deposit Overdraft transfer from ****190-S0","","200","","202.62"
"8/13/2024","","DEBIT","Withdrawal  @ SHELL OIL 574430170 0 SHELL OIL 574430 SACRAMENTO CA US","-10","","","192.62"
"8/13/2024","","DEBIT","Withdrawal  @ ATMX031258 2315 J ST CSSI0 EFT Sacramento CA US","-43","","","149.62"
"8/13/2024","","DEBIT","Withdrawal ATM:Fee: ATM FEE DRAFT WITHDRAWAL Trace #45475","-2","","","147.62"
"8/13/2024","","CREDIT","ATM FEE DRAFT WITHDRAWAL Trace #45475 1 @ $2.00","","0","","0.0"
"8/14/2024","","DEBIT","Withdrawal  @ DALEK ONE* SUBSCR 1 0 DALEK ONE* SUBSC HTTPSDALEKONEMN US","-7","","","140.62"
"8/15/2024","","DEBIT","Withdrawal  @ TRADER JOE S #17 TR 0 TRADER JOE S #17 SACRAMENTO CA US","-71.52","","","69.1"
"8/16/2024","","DEBIT","Withdrawal  @ EB CYMATICS EVENTS 0 EB CYMATICS EVEN 8014137200 CA US","-15.18","","","53.92"
"8/18/2024","","DEBIT","Withdrawal  @ SACRAMENTO NATURAL 0 SACRAMENTO NATUR SACRAMENTO CA US","-95.58","","","-41.66"
"8/18/2024","","CREDIT","Checking Deposit Overdraft transfer from ****190-S0","","200","","158.34"
"8/19/2024","","DEBIT","Withdrawal  @ AMAZON MKTPL*R42C76 0 AMAZON MKTPL*R42 Amzn.com/billWA US","-14.37","","","143.97"
"8/19/2024","","DEBIT","Withdrawal  @ Amazon.com*RU5PL1QN 0 Amazon.com*RU5PL Amzn.com/billWA US","-4.94","","","139.03"
"8/19/2024","","DEBIT","Withdrawal  @ Spotify USA 0 Spotify USA 877-7781161 NY US","-11.99","","","127.04"
"8/20/2024","","DEBIT","Withdrawal  @ SHELL OIL 574430170 0 SHELL OIL 574430 SACRAMENTO CA US","-9.84","","","117.2"
"8/20/2024","","DEBIT","Withdrawal  @ SPLICE.COM* SPLICE 0 SPLICE.COM* SPLI SPLICE.COM NY US","-9.99","","","107.21"
"8/21/2024","","DEBIT","Withdrawal  @ BONFARE MARKET #33 0 BONFARE MARKET # SACRAMENTO CA US","-7.71","","","99.5"
"8/21/2024","","DEBIT","Withdrawal  @ 1001 Sacramento Av 0 MARATHON PETRO17 West SacramenCA US","-30.31","","","69.19"
"8/21/2024","","DEBIT","Withdrawal  @ PADDLE.NET* KAIBER 0 PADDLE.NET* KAIB PADDLE.COM NY US","-15","","","54.19"
"8/21/2024","","DEBIT","Withdrawal  @ SQ *TEMPLE COFFEE K 0 SQ *TEMPLE COFFE Sacramento CA US","-6.2","","","47.99"
"8/22/2024","","DEBIT","Withdrawal  @ BONFARE MARKET #33 0 BONFARE MARKET # SACRAMENTO CA US","-5.54","","","42.45"
"8/22/2024","","DEBIT","Withdrawal  @ AMAZON MARK* R44VG3 0 AMAZON MARK* R44 HTTPSAMAZON.CWA US","-15.21","","","27.24"
"8/23/2024","","DEBIT","Withdrawal  @ NETFLIX.COM 0 NETFLIX.COM LOS GATOS CA US","-15.49","","","11.75"
"8/23/2024","","CREDIT","Checking Deposit Overdraft transfer from ****190-S0","","200","","211.75"
"8/23/2024","","DEBIT","Withdrawal  @ TST* LOWBRAU 0 TST* LOWBRAU SACRAMENTO CA US","-37.43","","","174.32"
"8/23/2024","","DEBIT","Withdrawal  @ SQ *TEMPLE COFFE 0 SQ *TEMPLE COFFE SACRAMENTO CA US","-11.73","","","162.59"
"8/23/2024","","DEBIT","Withdrawal  @ ATMX031258 2315 J ST CSSI0 EFT Sacramento CA US","-43","","","119.59"
"8/24/2024","","DEBIT","Withdrawal  @ BONFARE MARKET #33 0 BONFARE MARKET # SACRAMENTO CA US","-7.71","","","111.88"
"8/24/2024","","DEBIT","Withdrawal  @ AMAZON MKTPL*R49QE0 0 AMAZON MKTPL*R49 Amzn.com/billWA US","-14.13","","","97.75"
"8/24/2024","","DEBIT","Withdrawal  @ AMAZON MKTPL*R43087 0 AMAZON MKTPL*R43 Amzn.com/billWA US","-14.13","","","83.62"
"8/24/2024","","DEBIT","Withdrawal  @ DD *DOORDASH NEWSTA 0 DD *DOORDASH NEW WWW.DOORDASH.CA US","-36.56","","","47.06"
"8/24/2024","","DEBIT","Withdrawal ATM:Fee: ATM FEE DRAFT WITHDRAWAL Trace #103491","-2","","","45.06"
"8/24/2024","","CREDIT","ATM FEE DRAFT WITHDRAWAL Trace #103491 1 @ $2.00","","0","","0.0"
"8/24/2024","","DEBIT","Withdrawal  @ TRADER JOE S #17 TR 0 TRADER JOE S #17 SACRAMENTO CA US","-33.16","","","11.9"
"8/25/2024","","DEBIT","Withdrawal  @ FLOWCHART FUN PRO 0 FLOWCHART FUN PR HTTPSFLOWCHARNC US","-3","","","8.9"
"8/25/2024","","DEBIT","Withdrawal  @ NUGGET MARKET #10 0 NUGGET MARKET #1 ROSEVILLE CA US","-71.97","","","-63.07"
"8/25/2024","","CREDIT","Checking Deposit Overdraft transfer from ****190-S0","","200","","136.93"
"8/26/2024","","DEBIT","Withdrawal  @ POSH BAGEL ROSEVILL 0 POSH BAGEL ROSEV ROSEVILLE CA US","-29.81","","","107.12"
"8/26/2024","","DEBIT","Withdrawal-ACH-A-1064712 WEBSMUD (WEB PAY)","-269.35","","","-162.23"
"8/26/2024","","CREDIT","Checking Deposit Overdraft transfer from ****190-S0","","200","","37.77"
"8/26/2024","","DEBIT","Withdrawal  @ APPLE.COM/BILL 0 APPLE.COM/BILL 866-712-7753 CA US","-13.99","","","23.78"
"8/27/2024","","DEBIT","Withdrawal  @ AMAZON MKTPL*RK6592 0 AMAZON MKTPL*RK6 Amzn.com/billWA US","-29.35","","","-5.57"
"8/27/2024","","CREDIT","Checking Deposit Overdraft transfer from ****190-S0","","200","","194.43"
"8/27/2024","","DEBIT","Withdrawal  @ LINDA S TAQUERIA 0 LINDA S TAQUERIA SACRAMENTO CA US","-20.82","","","173.61"
"8/27/2024","","DEBIT","Withdrawal  @ 50 Beal St Suite 60 0 Instacart San FrancisCA US","-42.01","","","131.6"
"8/27/2024","","CREDIT","Checking Deposit Overdraft transfer from ****190-S0","","200","","331.6"
"8/28/2024","","DEBIT","Withdrawal-ACH-A-1096016 ATT (Payment)","-84.99","","","246.61"
"8/28/2024","","DEBIT","Withdrawal  @ CA DMV FEE 0 CA DMV FEE 678-7315516 TN US","-0.88","","","245.73"
"8/28/2024","","DEBIT","Withdrawal  @ STATE OF CALIF DMV 0 STATE OF CALIF D 800-7770133 CA US","-45","","","200.73"
"8/28/2024","","DEBIT","Withdrawal  @ CITYOFSAC-PARKINGWE 0 CITYOFSAC-PARKIN 916-808-5110 CA US","-132.5","","","68.23"
"8/28/2024","","DEBIT","Withdrawal  @ PETCO 1343 0 PETCO 1343 SACRAMENTO CA US","-20.07","","","48.16"
"8/28/2024","","DEBIT","Withdrawal  @ 5810 FOLSOM BLVD 0 CORTI BROTHERS SACRAMENTO CA US","-57.46","","","-9.3"
"8/28/2024","","CREDIT","Checking Deposit Overdraft transfer from ****190-S0","","200","","190.7"
"8/28/2024","","DEBIT","Withdrawal  @ 50 Beal St Suite 60 0 Instacart San FrancisCA US","-18.04","","","172.66"
"8/29/2024","","DEBIT","Withdrawal  @ DD *DOORDASH NSTREE 0 DD *DOORDASH NST WWW.DOORDASH.CA US","-15.23","","","157.43"
"8/29/2024","","DEBIT","Withdrawal  @ APPLE.COM/BILL 0 APPLE.COM/BILL 866-712-7753 CA US","-12.99","","","144.44"
"8/29/2024","","DEBIT","Withdrawal  @ ATMX031258 2315 J ST CSSI0 EFT Sacramento CA US","-23","","","121.44"
"8/29/2024","","DEBIT","Withdrawal  @ SAC CITY COMPUTER H 0 SAC CITY COMPUTE SACRAMENTO CA US","-12","","","109.44"
"8/29/2024","","DEBIT","Withdrawal ATM:Fee: ATM FEE DRAFT WITHDRAWAL Trace #73841","-2","","","107.44"
"8/29/2024","","CREDIT","ATM FEE DRAFT WITHDRAWAL Trace #73841 1 @ $2.00","","0","","0.0"
"8/29/2024","","DEBIT","Withdrawal  @ VOCLR.IT 0 VOCLR.IT SALISBURY GB GB","-10.09","","","97.35"
"8/29/2024","","CREDIT","ISA Single-Currency Fee Assessed = 0.10 on 9.99 - Recurring or Installment payment","","0","","0.0"
"8/30/2024","","DEBIT","Withdrawal  @ BONFARE MARKET #33 0 BONFARE MARKET # SACRAMENTO CA US","-4.99","","","92.36"
"8/30/2024","","DEBIT","Withdrawal  @ OPENAI *CHATGPT SUB 0 OPENAI *CHATGPT HTTPSOPENAI.CCA US","-20","","","72.36"
"8/30/2024","","DEBIT","Withdrawal  @ BEL AIR MART 501 0 BEL AIR MART 501 SACRAMENTO CA US","-20.08","","","52.28"
"8/31/2024","","DEBIT","Withdrawal  @ BONFARE MARKET #33 0 BONFARE MARKET # SACRAMENTO CA US","-4.99","","","47.29"
"8/31/2024","","DEBIT","Withdrawal  @ EMBRACE PET INSURAN 0 EMBRACE PET INSU HELLO@EMBRACEOH US","-17.89","","","29.4"
"8/31/2024","","DEBIT","Withdrawal  @ BEL AIR MART 501 0 BEL AIR MART 501 SACRAMENTO CA US","-34.81","","","-5.41"
"8/31/2024","","CREDIT","Checking Deposit Overdraft transfer from ****190-S0","","200","","194.59"
"9/1/2024","","DEBIT","Withdrawal  @ APPLE.COM/BILL 0 APPLE.COM/BILL 866-712-7753 CA US","-2.99","","","191.6"
"9/1/2024","","DEBIT","Withdrawal  @ Google LLC GSUITE b 0 Google LLC GSUIT 650-2530000 CA US","-14.4","","","177.2"
"9/1/2024","","DEBIT","Withdrawal  @ SOUNDCLOUD INC 0 SOUNDCLOUD INC 176-3257837 NY US","-16","","","161.2"
"9/2/2024","","DEBIT","Withdrawal  @ SAFEWAY #2242 0 SAFEWAY #2242 SACRAMENTO CA US","-8.98","","","152.22"
"9/2/2024","","DEBIT","Withdrawal  @ ATMX031258 2315 J ST CSSI0 EFT Sacramento CA US","-23","","","129.22"
"9/2/2024","","DEBIT","Withdrawal  @ Amazon web services 0 Amazon web servi aws.amazon.coWA US","-1.33","","","127.89"
"9/2/2024","","DEBIT","Withdrawal ATM:Fee: ATM FEE DRAFT WITHDRAWAL Trace #121103","-2","","","125.89"
"9/2/2024","","CREDIT","ATM FEE DRAFT WITHDRAWAL Trace #121103 1 @ $2.00","","0","","0.0"
"9/3/2024","","DEBIT","Withdrawal  @ Prime Video *ZT33D6 0 Prime Video *ZT3 888-802-3080 WA US","-5.99","","","119.9"
"9/3/2024","","CREDIT","Checking Deposit  @ G1 Online Transfer 'STD' 220.00 from share 0","","220","","339.9"
"9/3/2024","","CREDIT","Checking Deposit  @ VENMO*Del Fava Marc 0 VENMO*Del Fava M New York CityNY US","","98.25","","438.15"
"9/4/2024","","DEBIT","Withdrawal  @ BONFARE MARKET #33 0 BONFARE MARKET # SACRAMENTO CA US","-4.99","","","433.16"
"9/4/2024","","DEBIT","Withdrawal-ACH-A-990166 WEBHomeRiver Group (WEB PMTS)","-755","","","-321.84"
"9/4/2024","","CREDIT","Checking Deposit Overdraft transfer from ****190-S0","","6.15","","-315.69"
"9/4/2024","","DEBIT","Withdrawal COURTESY PAY FEE 20.00","-20","","","-335.69"
"9/4/2024","","CREDIT","A Courtesy Payment was made for the amount of 315.69.","","0","","0.0"
"9/5/2024","","DEBIT","Withdrawal-ACH-A-861479 GEICO (PREM COLL)","-56.55","","","-392.24"
"9/5/2024","","DEBIT","Withdrawal COURTESY PAY FEE 20.00","-20","","","-412.24"
"9/5/2024","","CREDIT","A Courtesy Payment was made for the amount of 56.55.","","0","","0.0"
"9/5/2024","","CREDIT","Checking Deposit  @ G1 Online Transfer 'STD' 500.00 from share 0","","500","","87.76"
"9/6/2024","","DEBIT","Withdrawal  @ 809 20TH ST 0 BONFARE MARKET # SACRAMENTO CA US","-30.89","","","56.87"
"9/6/2024","","DEBIT","Withdrawal  @ 5810 FOLSOM BLVD 0 CORTI BROTHERS SACRAMENTO CA US","-26.9","","","29.97"
"9/6/2024","","CREDIT","Checking Deposit Overdraft transfer from ****190-S0","","200","","229.97"
"9/6/2024","","DEBIT","Withdrawal  @ AMAZON RETA* ZT73E2 0 AMAZON RETA* ZT7 WWW.AMAZON.COWA US","-38.64","","","191.33"
"9/6/2024","","DEBIT","Withdrawal  @ ATMX031258 2315 J ST CSSI0 EFT Sacramento CA US","-43","","","148.33"
"9/7/2024","","DEBIT","Withdrawal  @ TST*CHICAGO FIRE SA 0 TST*CHICAGO FIRE Sacramento CA US","-45.57","","","102.76"
"9/7/2024","","DEBIT","Withdrawal  @ SACRAMENTO NATURAL 0 SACRAMENTO NATUR SACRAMENTO CA US","-85.43","","","17.33"
"9/7/2024","","DEBIT","Withdrawal  @ SQ *JACOB?S FARM 0 SQ *JACOB?S FARM Sacramento CA US","-15.9","","","1.43"
"9/7/2024","","DEBIT","Withdrawal ATM:Fee: ATM FEE DRAFT WITHDRAWAL Trace #129905","-2","","","-0.57"
"9/7/2024","","CREDIT","ATM FEE DRAFT WITHDRAWAL Trace #129905 1 @ $2.00","","0","","0.0"
"9/7/2024","","CREDIT","Checking Deposit Overdraft transfer from ****190-S0","","0.57","","0"
"9/8/2024","","DEBIT","Withdrawal  @ AMAZON MKTPL*ZT7681 0 AMAZON MKTPL*ZT7 Amzn.com/billWA US","-7.6","","","-7.6"
"9/8/2024","","CREDIT","Checking Deposit Overdraft transfer from ****190-S0","","200","","192.4"
"9/10/2024","","DEBIT","Withdrawal  @ BONFARE MARKET #33 0 BONFARE MARKET # SACRAMENTO CA US","-4.99","","","187.41"
"9/10/2024","","DEBIT","Withdrawal  @ CKE*GORDITO BURRITO 0 CKE*GORDITO BURR SACRAMENTO CA US","-10.64","","","176.77"
"9/10/2024","","DEBIT","Withdrawal-ACH-A-983291 WEBADVS ED SERV WEB (STUDNTLOAN)","-150","","","26.77"
"9/10/2024","","DEBIT","Withdrawal  @ ATMX031258 2315 J ST CSSI0 EFT Sacramento CA US","-43","","","-16.23"
"9/10/2024","","CREDIT","Checking Deposit Overdraft transfer from ****190-S0","","200","","183.77"
"9/10/2024","","DEBIT","Withdrawal  @ SQ *THE MILL 0 SQ *THE MILL Sacramento CA US","-5.58","","","178.19"
"9/10/2024","","DEBIT","Withdrawal ATM:Fee: ATM FEE DRAFT WITHDRAWAL Trace #193290","-2","","","176.19"
"9/10/2024","","CREDIT","ATM FEE DRAFT WITHDRAWAL Trace #193290 1 @ $2.00","","0","","0.0"
"9/11/2024","","DEBIT","Withdrawal  @ CITYOFSAC IPS PKGME 0 CITYOFSAC IPS PK SACRAMENTO CA US","-2","","","174.19"
"9/11/2024","","DEBIT","Withdrawal  @ CITYOFSAC IPS PKGME 0 CITYOFSAC IPS PK SACRAMENTO CA US","-2","","","172.19"
"9/11/2024","","DEBIT","Withdrawal  @ JALAPENO'S AND COMP 0 JALAPENO'S AND C SACRAMENTO CA US","-14.82","","","157.37"
"9/11/2024","","DEBIT","Withdrawal  @ BONFARE MARKET #33 0 BONFARE MARKET # SACRAMENTO CA US","-7.71","","","149.66"
"9/11/2024","","DEBIT","Withdrawal  @ AZUL MEXICAN FOOD & 0 AZUL MEXICAN FOO SACRAMENTO CA US","-32.14","","","117.52"
"9/12/2024","","DEBIT","Withdrawal  @ ZZOUNDS.COM 0 ZZOUNDS.COM 800-493-3945 NJ US","-49.75","","","67.77"
"9/12/2024","","DEBIT","Withdrawal  @ CORTI BROTHERS 0 CORTI BROTHERS SACRAMENTO CA US","-32.94","","","34.83"
"9/13/2024","","DEBIT","Withdrawal  @ BONFARE MARKET #33 0 BONFARE MARKET # SACRAMENTO CA US","-7.71","","","27.12"
"9/14/2024","","DEBIT","Withdrawal  @ BONFARE MARKET #33 0 BONFARE MARKET # SACRAMENTO CA US","-3.64","","","23.48"
"9/14/2024","","DEBIT","Withdrawal  @ BONFARE MARKET #33 0 BONFARE MARKET # SACRAMENTO CA US","-7.71","","","15.77"
"9/15/2024","","DEBIT","Withdrawal  @ MARINWOOD MARKET 0 MARINWOOD MARKET SAN RAFAEL CA US","-28.89","","","-13.12"
"9/15/2024","","CREDIT","Checking Deposit Overdraft transfer from ****190-S0","","200","","186.88"
"9/15/2024","","DEBIT","Withdrawal  @ MARINWOOD MARKET 0 MARINWOOD MARKET SAN RAFAEL CA US","-2.42","","","184.46"
"9/15/2024","","DEBIT","Withdrawal  @ BONFARE MARKET #33 0 BONFARE MARKET # SACRAMENTO CA US","-14.45","","","170.01"
"9/15/2024","","DEBIT","Withdrawal  @ DALEK ONE* SUBSCR 1 0 DALEK ONE* SUBSC HTTPSDALEKONEMN US","-7","","","163.01"
"9/15/2024","","DEBIT","Withdrawal  @ TST*STATION HOUSE C 0 TST*STATION HOUS Point Reyes SCA US","-61.87","","","101.14"
"9/16/2024","","DEBIT","Withdrawal  @ FIRST CLASS VENDING 0 FIRST CLASS VEND RENO NV US","-4.1","","","97.04"
"9/16/2024","","DEBIT","Withdrawal  @ FIRST CLASS VENDING 0 FIRST CLASS VEND RENO NV US","-4.1","","","92.94"
"9/16/2024","","DEBIT","Withdrawal  @ RENO SPARKS CC PARK 0 RENO SPARKS CC P RENO NV US","-10","","","82.94"
"9/16/2024","","DEBIT","Withdrawal  @ APPLE CASH SENT MON 0 APPLE CASH SENT 1INFINITELOOPCA US","-30","","","52.94"
"9/16/2024","","DEBIT","Withdrawal  @ APPLE CASH SENT MON 0 APPLE CASH SENT 1INFINITELOOPCA US","-20","","","32.94"
"9/16/2024","","DEBIT","Withdrawal  @ MARCONI EXPRESS 0 MARCONI EXPRESS SACRAMENTO CA US","-1.74","","","31.2"
"9/16/2024","","DEBIT","Withdrawal  @ STARBUCKS STORE 521 0 STARBUCKS STORE TRUCKEE CA US","-13.3","","","17.9"
"9/17/2024","","DEBIT","Withdrawal  @ BONFARE MARKET #33 0 BONFARE MARKET # SACRAMENTO CA US","-7.71","","","10.19"
"9/17/2024","","CREDIT","Checking Deposit Overdraft transfer from ****190-S0","","135.08","","145.27"
"9/17/2024","","DEBIT","Withdrawal  @ TAQUERIA LA PERLA T 0 TAQUERIA LA PERL SACRAMENTO CA US","-11.58","","","133.69"
"9/18/2024","","DEBIT","Withdrawal  @ BEATPORT 0 BEATPORT 720-974-9500 CO US","-28.62","","","105.07"
"9/18/2024","","DEBIT","Withdrawal  @ SHELL OIL 574430170 0 SHELL OIL 574430 SACRAMENTO CA US","-21.31","","","83.76"
"9/19/2024","","DEBIT","Withdrawal  @ BANDCAMP ESCPE 0 BANDCAMP ESCPE 415-213-2160 CA US","-2.28","","","81.48"
"9/19/2024","","DEBIT","Withdrawal  @ BANDCAMP MURKURY 0 BANDCAMP MURKURY 415-213-2160 CA US","-5","","","76.48"
"9/19/2024","","DEBIT","Withdrawal  @ BANDCAMP ARTIKAL MU 0 BANDCAMP ARTIKAL BANDCAMPCOM CA US","-4.35","","","72.13"
"9/19/2024","","DEBIT","Withdrawal  @ Spotify USA 0 Spotify USA 877-7781161 NY US","-11.99","","","60.14"
"9/20/2024","","DEBIT","Withdrawal  @ BEATPORT 0 BEATPORT 720-974-9500 CO US","-7.45","","","52.69"
"9/20/2024","","DEBIT","Withdrawal  @ SPLICE.COM* SPLICE 0 SPLICE.COM* SPLI SPLICE.COM NY US","-9.99","","","42.7"
"9/20/2024","","DEBIT","Withdrawal  @ VENMO *Eva DiGiorg 0 VENMO *Eva DiGi Visa Direct NY US","-20","","","22.7"
"9/20/2024","","CREDIT","Checking Deposit Overdraft transfer from ****190-S0","","200","","222.7"
"9/20/2024","","DEBIT","Withdrawal  @ ATMX031258 2315 J ST CSSI0 EFT Sacramento CA US","-43","","","179.7"
"9/20/2024","","DEBIT","Withdrawal  @ 5810 FOLSOM BLVD 0 CORTI BROTHERS SACRAMENTO CA US","-56.58","","","123.12"
"9/20/2024","","DEBIT","Withdrawal ATM:Fee: ATM FEE DRAFT WITHDRAWAL Trace #46276","-2","","","121.12"
"9/20/2024","","CREDIT","ATM FEE DRAFT WITHDRAWAL Trace #46276 1 @ $2.00","","0","","0.0"
"9/21/2024","","DEBIT","Withdrawal  @ PADDLE.NET* KAIBER 0 PADDLE.NET* KAIB PADDLE.COM NY US","-15","","","106.12"
"9/21/2024","","DEBIT","Withdrawal  @ AZUL MEXICAN FOOD & 0 AZUL MEXICAN FOO SACRAMENTO CA US","-33.82","","","72.3"
"9/21/2024","","DEBIT","Withdrawal  @ TRADER JOE S #17 TR 0 TRADER JOE S #17 SACRAMENTO CA US","-13.21","","","59.09"
"9/21/2024","","DEBIT","Withdrawal  @ PETCO 1343 0 PETCO 1343 SACRAMENTO CA US","-49.21","","","9.88"
"9/21/2024","","CREDIT","Checking Deposit Overdraft transfer from ****190-S0","","200","","209.88"
"9/21/2024","","DEBIT","Withdrawal  @ SAFEWAY #2242 0 SAFEWAY #2242 SACRAMENTO CA US","-42.14","","","167.74"
"9/21/2024","","DEBIT","Withdrawal  @ AMAZON MKTPL*IK4AH9 0 AMAZON MKTPL*IK4 Amzn.com/billWA US","-5.43","","","162.31"
"9/22/2024","","DEBIT","Withdrawal  @ APPLE.COM/BILL 0 APPLE.COM/BILL 866-712-7753 CA US","-13.99","","","148.32"
"9/22/2024","","DEBIT","Withdrawal  @ SACRAMENTO NATURAL 0 SACRAMENTO NATUR SACRAMENTO CA US","-27.12","","","121.2"
"9/23/2024","","DEBIT","Withdrawal  @ NETFLIX COM 0 NETFLIX COM LOS GATOS CA US","-15.49","","","105.71"
"9/23/2024","","DEBIT","Withdrawal  @ AMAZON MKTPL*201IW4 0 AMAZON MKTPL*201 Amzn.com/billWA US","-8.69","","","97.02"
"9/23/2024","","DEBIT","Withdrawal  @ 809 20TH ST 0 BONFARE MARKET # SACRAMENTO CA US","-19.64","","","77.38"
"9/23/2024","","DEBIT","Withdrawal  @ SACRAMENTO NATURAL 0 SACRAMENTO NATUR SACRAMENTO CA US","-18.94","","","58.44"
"9/24/2024","","DEBIT","Withdrawal  @ CITYOFSAC IPS PKGME 0 CITYOFSAC IPS PK SACRAMENTO CA US","-2","","","56.44"
"9/24/2024","","DEBIT","Withdrawal  @ N STREET CAFE 0 N STREET CAFE SACRAMENTO CA US","-12.9","","","43.54"
"9/24/2024","","DEBIT","Withdrawal  @ SACRAMENTO NATURAL 0 SACRAMENTO NATUR SACRAMENTO CA US","-46.27","","","-2.73"
"9/24/2024","","CREDIT","Checking Deposit Overdraft transfer from ****190-S0","","200","","197.27"
"9/24/2024","","DEBIT","Withdrawal  @ FLOWCHART FUN PRO 0 FLOWCHART FUN PR HTTPSFLOWCHARNC US","-3","","","194.27"
"9/25/2024","","DEBIT","Withdrawal-ACH-A-1064712 WEBSMUD (WEB PAY)","-296.01","","","-101.74"
"9/25/2024","","CREDIT","Checking Deposit Overdraft transfer from ****190-S0","","200","","98.26"
"9/25/2024","","DEBIT","Withdrawal  @ SACRAMENTO NATURAL 0 SACRAMENTO NATUR SACRAMENTO CA US","-67.79","","","30.47"
"9/25/2024","","DEBIT","Withdrawal  @ SACRAMENTO NATURAL 0 SACRAMENTO NATUR SACRAMENTO CA US","-2.98","","","27.49"
"9/26/2024","","DEBIT","Withdrawal  @ BONFARE MARKET #33 0 BONFARE MARKET # SACRAMENTO CA US","-4.99","","","22.5"
"9/27/2024","","DEBIT","Withdrawal  @ BONFARE MARKET #33 0 BONFARE MARKET # SACRAMENTO CA US","-4.99","","","17.51"
"9/27/2024","","CREDIT","Checking Deposit Overdraft transfer from ****190-S0","","200","","217.51"
"9/27/2024","","DEBIT","Withdrawal  @ BONFARE MARKET #33 0 BONFARE MARKET # SACRAMENTO CA US","-5.97","","","211.54"
"9/27/2024","","DEBIT","Withdrawal  @ TST*SACYARD COMMUNI 0 TST*SACYARD COMM Sacramento CA US","-10.44","","","201.1"
"9/27/2024","","DEBIT","Withdrawal  @ TST*SACYARD COMMUNI 0 TST*SACYARD COMM Sacramento CA US","-10.44","","","190.66"
"9/27/2024","","DEBIT","Withdrawal  @ SQ *TEMPLE COFFE 0 SQ *TEMPLE COFFE SACRAMENTO CA US","-11.79","","","178.87"
"9/27/2024","","DEBIT","Withdrawal  @ ATMX031258 2315 J ST CSSI0 EFT Sacramento CA US","-23","","","155.87"
"9/28/2024","","DEBIT","Withdrawal  @ EB *OVER YONDER FT. 0 EB *OVER YONDER 8014137200 CA US","-28.52","","","127.35"
"9/28/2024","","DEBIT","Withdrawal  @ EB *OVER YONDER FT. 0 EB *OVER YONDER 8014137200 CA US","-28.52","","","98.83"
"9/28/2024","","DEBIT","Withdrawal  @ BONFARE MARKET #33 0 BONFARE MARKET # SACRAMENTO CA US","-4.99","","","93.84"
"9/28/2024","","DEBIT","Withdrawal  @ 755 RIVERPOINT CT 0 WAL-MART #3652 WEST SACRAMENCA US","-20.49","","","73.35"
"9/28/2024","","DEBIT","Withdrawal  @ SHELL SERVICE STATI 0 SHELL SERVICE ST SACRAMENTO CA US","-57.75","","","15.6"
"9/28/2024","","CREDIT","Checking Deposit Overdraft transfer from ****190-S0","","200","","215.6"
"9/28/2024","","DEBIT","Withdrawal ATM:Fee: ATM FEE DRAFT WITHDRAWAL Trace #153254","-2","","","213.6"
"9/28/2024","","CREDIT","ATM FEE DRAFT WITHDRAWAL Trace #153254 1 @ $2.00","","0","","0.0"
"9/29/2024","","DEBIT","Withdrawal  @ AZUL MEXICAN FOOD & 0 AZUL MEXICAN FOO SACRAMENTO CA US","-27.89","","","185.71"
"9/29/2024","","DEBIT","Withdrawal  @ APPLE.COM/BILL 0 APPLE.COM/BILL 866-712-7753 CA US","-12.99","","","172.72"
"9/29/2024","","DEBIT","Withdrawal  @ SQ *TEMPLE COFFE 0 SQ *TEMPLE COFFE SACRAMENTO CA US","-26.25","","","146.47"
"9/29/2024","","DEBIT","Withdrawal  @ SACRAMENTO NATURAL 0 SACRAMENTO NATUR SACRAMENTO CA US","-25.46","","","121.01"
"9/29/2024","","DEBIT","Withdrawal  @ SAFEWAY #2242 0 SAFEWAY #2242 SACRAMENTO CA US","-6.99","","","114.02"
"9/29/2024","","DEBIT","Withdrawal  @ VOCLR.IT 0 VOCLR.IT SALISBURY GB GB","-10.09","","","103.93"
"9/29/2024","","CREDIT","ISA Single-Currency Fee Assessed = 0.10 on 9.99 - Recurring or Installment payment","","0","","0.0"
"9/30/2024","","DEBIT","Withdrawal  @ LOVE LAUNDRY 0 LOVE LAUNDRY SACRAMENTO CA US","-17.5","","","86.43"
"9/30/2024","","DEBIT","Withdrawal  @ LOVE LAUNDRY 0 LOVE LAUNDRY SACRAMENTO CA US","-9.85","","","76.58"
"9/30/2024","","DEBIT","Withdrawal  @ BONFARE MARKET #33 0 BONFARE MARKET # SACRAMENTO CA US","-4.99","","","71.59"
"9/30/2024","","DEBIT","Withdrawal-ACH-A-1096016 ATT (Payment)","-84.99","","","-13.4"
"9/30/2024","","CREDIT","Checking Deposit Overdraft transfer from ****190-S0","","200","","186.6"
"9/30/2024","","DEBIT","Withdrawal  @ AZUL MEXICAN FOOD & 0 AZUL MEXICAN FOO SACRAMENTO CA US","-7.52","","","179.08"
"9/30/2024","","DEBIT","Withdrawal  @ OPENAI *CHATGPT SUB 0 OPENAI *CHATGPT HTTPSOPENAI.CCA US","-20","","","159.08"
"9/30/2024","","DEBIT","Withdrawal  @ SACRAMENTO NATURAL 0 SACRAMENTO NATUR SACRAMENTO CA US","-15.96","","","143.12"
"10/1/2024","","DEBIT","Withdrawal  @ GOOGLE GSUITE bark 0 GOOGLE GSUITE b 650-2530000 CA US","-14.4","","","128.72"
"10/1/2024","","DEBIT","Withdrawal  @ EMBRACE PET INSURAN 0 EMBRACE PET INSU HELLO@EMBRACEOH US","-23.35","","","105.37"
"10/1/2024","","DEBIT","Withdrawal  @ TST*ESTELLE BAKERY 0 TST*ESTELLE BAKE Sacramento CA US","-14.45","","","90.92"
"10/1/2024","","DEBIT","Withdrawal  @ APPLE.COM/BILL 0 APPLE.COM/BILL 866-712-7753 CA US","-2.99","","","87.93"
"10/1/2024","","DEBIT","Withdrawal  @ SOUNDCLOUD INC 0 SOUNDCLOUD INC 176-3257837 NY US","-16","","","71.93"
"10/2/2024","","DEBIT","Withdrawal  @ BONFARE MARKET #33 0 BONFARE MARKET # SACRAMENTO CA US","-4.99","","","66.94"
"10/2/2024","","DEBIT","Withdrawal  @ Amazon web services 0 Amazon web servi aws.amazon.coWA US","-15.75","","","51.19"
"10/3/2024","","DEBIT","Withdrawal  @ BONFARE MARKET #33 0 BONFARE MARKET # SACRAMENTO CA US","-4.99","","","46.2"
"10/3/2024","","DEBIT","Withdrawal  @ BONFARE MARKET #33 0 BONFARE MARKET # SACRAMENTO CA US","-4.99","","","41.21"
"10/3/2024","","DEBIT","Withdrawal  @ SAFEWAY #2242 0 SAFEWAY #2242 SACRAMENTO CA US","-11.48","","","29.73"
"10/4/2024","","DEBIT","Withdrawal  @ BONFARE MARKET #33 0 BONFARE MARKET # SACRAMENTO CA US","-4.99","","","24.74"
"10/4/2024","","CREDIT","ACH Returns: HomeRiver Group (WEB PMTS)  755.00 NSF| Balance=$24.74. Available Balance=$24.74. Available Balance with ODP=$172.45.","","0","","0.0"
"10/4/2024","","DEBIT","Withdrawal  @ ATMX031258 2315 J ST CSSI0 EFT Sacramento CA US","-43","","","-18.26"
"10/4/2024","","CREDIT","Checking Deposit Overdraft transfer from ****190-S0","","147.71","","129.45"
"10/5/2024","","DEBIT","Withdrawal  @ SHELL SERVICE STATI 0 SHELL SERVICE ST SACRAMENTO CA US","-15.57","","","113.88"
"10/5/2024","","DEBIT","Withdrawal ATM:Fee: ATM FEE DRAFT WITHDRAWAL Trace #94244","-2","","","111.88"
"10/5/2024","","CREDIT","ATM FEE DRAFT WITHDRAWAL Trace #94244 1 @ $2.00","","0","","0.0"
"10/6/2024","","DEBIT","Withdrawal  @ Amazon Prime*E94P82 0 Amazon Prime*E94 Amzn.com/billWA US","-8.15","","","103.73"
"10/6/2024","","DEBIT","Withdrawal  @ AZUL MEXICAN FOOD & 0 AZUL MEXICAN FOO SACRAMENTO CA US","-27.38","","","76.35"
"10/6/2024","","DEBIT","Withdrawal  @ SHELL OIL 574430170 0 SHELL OIL 574430 SACRAMENTO CA US","-55.45","","","20.9"
"10/6/2024","","DEBIT","Withdrawal  @ VENMO *Eva DiGiorg 0 VENMO *Eva DiGi Visa Direct NY US","-70","","","-49.1"
"10/6/2024","","CREDIT","Checking Deposit Overdraft transfer from ****190-S0","","200","","150.9"
"10/6/2024","","DEBIT","Withdrawal  @ LALAL.AI 0 LALAL.AI ZUG CH CH","-10.1","","","140.8"
"10/6/2024","","CREDIT","ISA Single-Currency Fee Assessed = 0.10 on 10.00 - Recurring or Installment payment","","0","","0.0"
"10/6/2024","","DEBIT","Withdrawal  @ AMZN Digital*430V84 0 AMZN Digital*430 888-802-3080 WA US","-7.44","","","133.36"
"10/6/2024","","DEBIT","Withdrawal  @ AMZN Digital*6P4DD7 0 AMZN Digital*6P4 888-802-3080 WA US","-1.29","","","132.07"
"10/7/2024","","DEBIT","Withdrawal  @ Amazon.com*MF5AZ8DJ 0 Amazon.com*MF5AZ Amzn.com/billWA US","-36.94","","","95.13"
"10/7/2024","","DEBIT","Withdrawal-ACH-A-861479 GEICO (PREM COLL)","-56.55","","","38.58"
"10/7/2024","","DEBIT","Withdrawal  @ AMZN Digital*IU9AY2 0 AMZN Digital*IU9 888-802-3080 WA US","-3.87","","","34.71"
"10/7/2024","","DEBIT","Withdrawal  @ 5810 FOLSOM BLVD 0 CORTI BROTHERS SACRAMENTO CA US","-46.74","","","-12.03"
"10/7/2024","","CREDIT","Checking Deposit Overdraft transfer from ****190-S0","","200","","187.97"
"10/9/2024","","DEBIT","Withdrawal  @ BONFARE MARKET #33 0 BONFARE MARKET # SACRAMENTO CA US","-3.8","","","184.17"
"10/9/2024","","DEBIT","Withdrawal  @ BONFARE MARKET #33 0 BONFARE MARKET # SACRAMENTO CA US","-7.71","","","176.46"
"10/9/2024","","DEBIT","Withdrawal-ACH-A-1064712 WEBSMUD (WEB PAY)","-233.35","","","-56.89"
"10/9/2024","","CREDIT","Checking Deposit Overdraft transfer from ****190-S0","","200","","143.11"
"10/9/2024","","DEBIT","Withdrawal  @ 809 20TH ST 0 BONFARE MARKET # SACRAMENTO CA US","-4.99","","","138.12"
"10/9/2024","","DEBIT","Withdrawal  @ SQ *TEMPLE COFFEE K 0 SQ *TEMPLE COFFE Sacramento CA US","-5.25","","","132.87"
"10/10/2024","","DEBIT","Withdrawal  @ BONFARE MARKET #33 0 BONFARE MARKET # SACRAMENTO CA US","-6.49","","","126.38"
"10/11/2024","","DEBIT","Withdrawal  @ BONFARE MARKET #33 0 BONFARE MARKET # SACRAMENTO CA US","-4.99","","","121.39"
"10/11/2024","","DEBIT","Withdrawal  @ BONFARE MARKET #33 0 BONFARE MARKET # SACRAMENTO CA US","-4.99","","","116.4"
"10/11/2024","","DEBIT","Withdrawal  @ LINDA S TAQUERIA 0 LINDA S TAQUERIA SACRAMENTO CA US","-21.04","","","95.36"
"10/12/2024","","DEBIT","Withdrawal  @ BONFARE MARKET #33 0 BONFARE MARKET # SACRAMENTO CA US","-4.99","","","90.37"
"10/12/2024","","DEBIT","Withdrawal  @ SAFEWAY #2242 0 SAFEWAY #2242 SACRAMENTO CA US","-5.48","","","84.89"
"10/12/2024","","DEBIT","Withdrawal  @ VENMO* Marc 0 VENMO* Marc Visa Direct NY US","-30","","","54.89"
"10/13/2024","","DEBIT","Withdrawal  @ ZZOUNDS.COM 0 ZZOUNDS.COM 800-493-3945 NJ US","-49.72","","","5.17"
"10/13/2024","","CREDIT","Checking Deposit Overdraft transfer from ****190-S0","","200","","205.17"
"10/13/2024","","DEBIT","Withdrawal  @ TRADER JOE S #17 TR 0 TRADER JOE S #17 SACRAMENTO CA US","-41.91","","","163.26"
"10/14/2024","","DEBIT","Withdrawal  @ AMAZON MKTPL*0W1XB8 0 AMAZON MKTPL*0W1 Amzn.com/billWA US","-16.3","","","146.96"
"10/14/2024","","DEBIT","Withdrawal  @ ATMX031258 2315 J ST CSSI0 EFT Sacramento CA US","-23","","","123.96"
"10/14/2024","","DEBIT","Withdrawal  @ DALEK ONE* SUBSCR 1 0 DALEK ONE* SUBSC DALEKONE.BANDMN US","-7","","","116.96"
"10/15/2024","","DEBIT","Withdrawal  @ SQ *PACHAMAMA COFFE 0 SQ *PACHAMAMA CO Sacramento CA US","-5.12","","","111.84"
"10/15/2024","","DEBIT","Withdrawal-ACH-A-990166 WEBHomeRiver Group (WEB PMTS)","-835","","","-723.16"
"10/15/2024","","CREDIT","Checking Deposit Overdraft transfer from ****190-S0","","800","","76.84"
"10/15/2024","","DEBIT","Withdrawal  @ ORBIT WASH 0 ORBIT WASH SACRAMENTO CA US","-10","","","66.84"
"10/15/2024","","DEBIT","Withdrawal  @ VENMO* Marc 0 VENMO* Marc Visa Direct NY US","-60","","","6.84"
"10/15/2024","","DEBIT","Withdrawal  @ N STREET CAFE 0 N STREET CAFE SACRAMENTO CA US","-13.98","","","-7.14"
"10/15/2024","","CREDIT","Checking Deposit Overdraft transfer from ****190-S0","","54.3","","47.16"
"10/15/2024","","DEBIT","Withdrawal ATM:Fee: ATM FEE DRAFT WITHDRAWAL Trace #61694","-2","","","45.16"
"10/15/2024","","CREDIT","ATM FEE DRAFT WITHDRAWAL Trace #61694 1 @ $2.00","","0","","0.0"
"10/16/2024","","DEBIT","Withdrawal  @ BONFARE MARKET #33 0 BONFARE MARKET # SACRAMENTO CA US","-4.34","","","40.82"
"10/16/2024","","DEBIT","Withdrawal  @ LYFT *RIDE TUE 7P 0 LYFT *RIDE TUE LYFT.COM CA US","-15.74","","","25.08"
"10/16/2024","","DEBIT","Withdrawal  @ SACRAMENTO NATURAL 0 SACRAMENTO NATUR SACRAMENTO CA US","-17.92","","","7.16"
"10/19/2024","","CREDIT","Checking Deposit  @ VENMO*DelFava Marc 0 VENMO*DelFava Ma New York CityNY US","","19.65","","26.81"
"10/20/2024","","CREDIT","Checking Deposit  @ APPLE CASH INST XFE 0 APPLE CASH INST CUPERTINO CA US","","29.55","","56.36"
"10/20/2024","","DEBIT","Withdrawal  @ VENMO* Marc 0 VENMO* Marc Visa Direct NY US","-50","","","6.36"
"10/20/2024","","DEBIT","Withdrawal  @ VENMO* Marc 0 VENMO* Marc Visa Direct NY US","-5","","","1.36"
"10/20/2024","","DEBIT","Withdrawal  @ VENMO* Marc 0 VENMO* Marc Visa Direct NY US","-1.3","","","0.06"
"10/22/2024","","DEBIT","Withdrawal  @ VENMO* Marc 0 VENMO* Marc Visa Direct NY US","-100","","","-99.94"
"10/22/2024","","CREDIT","Checking Deposit Overdraft transfer from ****190-S0","","200","","100.06"
"10/22/2024","","DEBIT","Withdrawal  @ SPLICE.COM* SPLICE 0 SPLICE.COM* SPLI SPLICE.COM NY US","-9.99","","","90.07"
"10/22/2024","","DEBIT","Withdrawal  @ 5810 FOLSOM BLVD 0 CORTI BROTHERS SACRAMENTO CA US","-52.73","","","37.34"
"10/22/2024","","DEBIT","Withdrawal  @ ATMX031258 2315 J ST CSSI0 EFT Sacramento CA US","-43","","","-5.66"
"10/22/2024","","CREDIT","Checking Deposit Overdraft transfer from ****190-S0","","200","","194.34"
"10/23/2024","","DEBIT","Withdrawal  @ EAST SAC ACE HARDWA 0 EAST SAC ACE HAR SACRAMENTO CA US","-20.65","","","173.69"
"10/23/2024","","DEBIT","Withdrawal  @ NETFLIX.COM 0 NETFLIX.COM LOS GATOS CA US","-15.49","","","158.2"
"10/23/2024","","DEBIT","Withdrawal  @ 809 20TH ST 0 BONFARE MARKET # SACRAMENTO CA US","-53.26","","","104.94"
"10/23/2024","","DEBIT","Withdrawal  @ Spotify USA 0 Spotify USA 877-7781161 NY US","-11.99","","","92.95"
"10/23/2024","","DEBIT","Withdrawal  @ 5810 FOLSOM BLVD 0 CORTI BROTHERS SACRAMENTO CA US","-30.27","","","62.68"
"10/23/2024","","DEBIT","Withdrawal ATM:Fee: ATM FEE DRAFT WITHDRAWAL Trace #173768","-2","","","60.68"
"10/23/2024","","CREDIT","ATM FEE DRAFT WITHDRAWAL Trace #173768 1 @ $2.00","","0","","0.0"
"10/24/2024","","DEBIT","Withdrawal  @ Prime Video *XG1UA1 0 Prime Video *XG1 888-802-3080 WA US","-3.99","","","56.69"
"10/24/2024","","DEBIT","Withdrawal  @ SAFEWAY #2242 0 SAFEWAY #2242 SACRAMENTO CA US","-8.56","","","48.13"
"10/24/2024","","DEBIT","Withdrawal  @ GITHUB INC. 0 GITHUB INC. HTTPSGITHUB.CCA US","-9.68","","","38.45"
"10/24/2024","","DEBIT","Withdrawal  @ PADDLE.NET* KAIBER 0 PADDLE.NET* KAIB PADDLE.COM NY US","-15","","","23.45"
"10/24/2024","","DEBIT","Withdrawal  @ 5810 FOLSOM BLVD 0 CORTI BROTHERS SACRAMENTO CA US","-9.5","","","13.95"
"10/25/2024","","DEBIT","Withdrawal  @ FLOWCHART FUN PRO 0 FLOWCHART FUN PR HTTPSFLOWCHARNC US","-3","","","10.95"
"10/25/2024","","DEBIT","Withdrawal  @ AZUL MEXICAN FOOD & 0 AZUL MEXICAN FOO SACRAMENTO CA US","-7.52","","","3.43"
"10/25/2024","","DEBIT","Withdrawal  @ SACRAMENTO NATURAL 0 SACRAMENTO NATUR SACRAMENTO CA US","-45.93","","","-42.5"
"10/25/2024","","CREDIT","Checking Deposit Overdraft transfer from ****190-S0","","200","","157.5"
"10/26/2024","","DEBIT","Withdrawal  @ SACRAMENTO NATURAL 0 SACRAMENTO NATUR SACRAMENTO CA US","-52.09","","","105.41"
"10/26/2024","","DEBIT","Withdrawal  @ ATMX031258 2315 J ST CSSI0 EFT Sacramento CA US","-43","","","62.41"
"10/27/2024","","DEBIT","Withdrawal  @ APPLE.COM/BILL 0 APPLE.COM/BILL 866-712-7753 CA US","-13.99","","","48.42"
"10/27/2024","","DEBIT","Withdrawal  @ SAFEWAY #2242 0 SAFEWAY #2242 SACRAMENTO CA US","-4.99","","","43.43"
"10/27/2024","","DEBIT","Withdrawal  @ H&S ENERGY PROD 0 H&S ENERGY PROD VALLEJO CA US","-40","","","3.43"
"10/27/2024","","DEBIT","Withdrawal ATM:Fee: ATM FEE DRAFT WITHDRAWAL Trace #193147","-2","","","1.43"
"10/27/2024","","CREDIT","ATM FEE DRAFT WITHDRAWAL Trace #193147 1 @ $2.00","","0","","0.0"
"10/27/2024","","CREDIT","Checking Deposit Overdraft transfer from ****190-S0","","2","","3.43"
"10/28/2024","","DEBIT","Withdrawal  @ SQ *LEVY @ WARFIELD 0 SQ *LEVY @ WARFI San FranciscoCA US","-37.34","","","-33.91"
"10/28/2024","","CREDIT","Checking Deposit Overdraft transfer from ****190-S0","","200","","166.09"
"10/28/2024","","DEBIT","Withdrawal  @ LAZ PARKING M18451- 0 LAZ PARKING M184 SAN FRANCISCOCA US","-30","","","136.09"
"10/28/2024","","DEBIT","Withdrawal  @ SACRAMENTO NATURAL 0 SACRAMENTO NATUR SACRAMENTO CA US","-16.9","","","119.19"
"10/29/2024","","DEBIT","Withdrawal  @ BONFARE MARKET #33 0 BONFARE MARKET # SACRAMENTO CA US","-5.97","","","113.22"
"10/29/2024","","DEBIT","Withdrawal-ACH-A-1096016 ATT (Payment)","-84.99","","","28.23"
"10/29/2024","","DEBIT","Withdrawal  @ SACRAMENTO NATURAL 0 SACRAMENTO NATUR SACRAMENTO CA US","-22.07","","","6.16"
"10/29/2024","","CREDIT","Checking Deposit Overdraft transfer from ****190-S0","","200","","206.16"
"10/29/2024","","DEBIT","Withdrawal  @ APPLE.COM/BILL 0 APPLE.COM/BILL 866-712-7753 CA US","-12.99","","","193.17"
"10/29/2024","","DEBIT","Withdrawal  @ SACRAMENTO NATURAL 0 SACRAMENTO NATUR SACRAMENTO CA US","-3.96","","","189.21"
"10/29/2024","","DEBIT","Withdrawal  @ VOCLR.IT 0 VOCLR.IT SALISBURY GB GB","-10.09","","","179.12"
"10/29/2024","","CREDIT","ISA Single-Currency Fee Assessed = 0.10 on 9.99 - Recurring or Installment payment","","0","","0.0"
"10/30/2024","","DEBIT","Withdrawal  @ G1 Online Transfer 'DTS' 90.00 to share 0","-90","","","89.12"
"10/30/2024","","DEBIT","Withdrawal  @ MOUNTAIN MIKES PIZZ 0 MOUNTAIN MIKES P SACRAMENTO CA US","-4.53","","","84.59"
"10/30/2024","","DEBIT","Withdrawal  @ OPENAI *CHATGPT SUB 0 OPENAI *CHATGPT HTTPSOPENAI.CCA US","-20","","","64.59"
"10/31/2024","","DEBIT","Withdrawal  @ EMBRACE PET INSURAN 0 EMBRACE PET INSU HELLO@EMBRACEOH US","-23.35","","","41.24"
"10/31/2024","","DEBIT","Withdrawal  @ ATMX031258 2315 J ST CSSI0 EFT Sacramento CA US","-23","","","18.24"
"10/31/2024","","CREDIT","Checking Deposit  @ VENMO*DelFava Marc 0 VENMO*DelFava Ma New York CityNY US","","19.65","","37.89"
"10/31/2024","","DEBIT","Withdrawal ATM:Fee: ATM FEE DRAFT WITHDRAWAL Trace #123704","-2","","","35.89"
"10/31/2024","","CREDIT","ATM FEE DRAFT WITHDRAWAL Trace #123704 1 @ $2.00","","0","","0.0"
"11/1/2024","","DEBIT","Withdrawal  @ GOOGLE *GSUITE bark 0 GOOGLE *GSUITE b cc@google.comCA US","-14.4","","","21.49"
"11/1/2024","","DEBIT","Withdrawal  @ APPLE.COM/BILL 0 APPLE.COM/BILL 866-712-7753 CA US","-2.99","","","18.5"
"11/1/2024","","DEBIT","Withdrawal  @ SOUNDCLOUD INC 0 SOUNDCLOUD INC 176-3257837 NY US","-16","","","2.5"
"11/2/2024","","DEBIT","Withdrawal  @ WWW.UNSTRUCTURED.IO 0 WWW.UNSTRUCTURED WWW.UNSTRUCTUCA US","-1.2","","","1.3"
"11/2/2024","","DEBIT","Withdrawal  @ Amazon web services 0 Amazon web servi aws.amazon.coWA US","-3.72","","","-2.42"
"11/2/2024","","CREDIT","Checking Deposit Overdraft transfer from ****190-S0","","200","","197.58"
"11/3/2024","","DEBIT","Withdrawal  @ G1 Online Transfer 'DTS' 197.00 to share 0","-197","","","0.58"
"11/3/2024","","CREDIT","Checking Deposit  @ G1 Online Transfer 'STD' 756.00 from share 0","","756","","756.58"
"11/4/2024","","DEBIT","Withdrawal  @ TRADER JOE S #17 TR 0 TRADER JOE S #17 SACRAMENTO CA US","-15.56","","","741.02"
"11/4/2024","","DEBIT","Withdrawal  @ TRADER JOE S #17 TR 0 TRADER JOE S #17 SACRAMENTO CA US","-3.16","","","737.86"
"11/5/2024","","DEBIT","Withdrawal  @ KAISER PHARM 02971 0 KAISER PHARM 029 SACRAMENTO CA US","-15","","","722.86"
"11/5/2024","","DEBIT","Withdrawal-ACH-A-861479 GEICO (PREM COLL)","-56.55","","","666.31"
"11/5/2024","","DEBIT","Withdrawal-ACH-A-990166 WEBHomeRiver Group (WEB PMTS)","-755","","","-88.69"
"11/5/2024","","CREDIT","Checking Deposit Overdraft transfer from ****190-S0","","0.57","","-88.12"
"11/5/2024","","DEBIT","Withdrawal COURTESY PAY FEE 20.00","-20","","","-108.12"
"11/5/2024","","CREDIT","A Courtesy Payment was made for the amount of 88.12.","","0","","0.0"
"11/6/2024","","CREDIT","Checking Deposit  @ G1 Online Transfer 'STD' 200.00 from share 0","","200","","91.88"
"11/7/2024","","DEBIT","Withdrawal-ACH-A-1064712 WEBSMUD (WEB PAY)","-133.56","","","-41.68"
"11/7/2024","","CREDIT","Checking Deposit Overdraft transfer from ****190-S0","","200","","158.32"
"11/7/2024","","DEBIT","Withdrawal  @ VENMO* Marc 0 VENMO* Marc Visa Direct NY US","-100","","","58.32"
"11/7/2024","","DEBIT","Withdrawal  @ 2401 BROADWAY 0 SMOG WIZARD SACRAMENTO CA US","-68","","","-9.68"
"11/7/2024","","CREDIT","Checking Deposit Overdraft transfer from ****190-S0","","200","","190.32"
"11/7/2024","","DEBIT","Withdrawal  @ SACRAMENTO NATURAL 0 SACRAMENTO NATUR SACRAMENTO CA US","-63.55","","","126.77"
"11/7/2024","","DEBIT","Withdrawal  @ ATMX031258 2315 J ST CSSI0 EFT Sacramento CA US","-43","","","83.77"
"11/7/2024","","DEBIT","Withdrawal ATM:Fee: ATM FEE DRAFT WITHDRAWAL Trace #196598","-2","","","81.77"
"11/7/2024","","CREDIT","ATM FEE DRAFT WITHDRAWAL Trace #196598 1 @ $2.00","","0","","0.0"
"11/8/2024","","DEBIT","Withdrawal  @ 809 20TH ST 0 BONFARE MARKET # SACRAMENTO CA US","-22.22","","","59.55"
"11/8/2024","","DEBIT","Withdrawal  @ AZUL MEXICAN FOOD & 0 AZUL MEXICAN FOO SACRAMENTO CA US","-24.32","","","35.23"
"11/8/2024","","DEBIT","Withdrawal  @ SACRAMENTO NATURAL 0 SACRAMENTO NATUR SACRAMENTO CA US","-6.94","","","28.29"
"11/9/2024","","DEBIT","Withdrawal  @ WWW.THEMID* MIDWAYS 0 WWW.THEMID* MIDW WWW.THEMIDWAYCA US","-49.44","","","-21.15"
"11/9/2024","","CREDIT","Checking Deposit Overdraft transfer from ****190-S0","","200","","178.85"
"11/9/2024","","CREDIT","Checking Deposit  @ BAGEL ST. CAFE-ANTI 0 BAGEL ST. CAFE-A ANTIOCH CA US","","35.82","","214.67"
"11/9/2024","","DEBIT","Withdrawal  @ BAGEL ST. CAFE-ANTI 0 BAGEL ST. CAFE-A ANTIOCH CA US","-35.82","","","178.85"
"11/10/2024","","DEBIT","Withdrawal  @ SQ *KARMA BREW 0 SQ *KARMA BREW Sacramento CA US","-24.49","","","154.36"
"11/10/2024","","DEBIT","Withdrawal  @ SQ *KARMA BREW 0 SQ *KARMA BREW Sacramento CA US","-12.38","","","141.98"
"11/10/2024","","DEBIT","Withdrawal  @ SQ *KARMA BREW 0 SQ *KARMA BREW Sacramento CA US","-12.38","","","129.6"
"11/10/2024","","DEBIT","Withdrawal  @ TST* B-SIDE 0 TST* B-SIDE SACRAMENTO CA US","-23.67","","","105.93"
"11/10/2024","","DEBIT","Withdrawal  @ LALAL.AI 0 LALAL.AI ZUG CH CH","-10.1","","","95.83"
"11/10/2024","","CREDIT","ISA Single-Currency Fee Assessed = 0.10 on 10.00 - Recurring or Installment payment","","0","","0.0"
"11/10/2024","","DEBIT","Withdrawal  @ 5810 FOLSOM BLVD 0 CORTI BROTHERS SACRAMENTO CA US","-61.96","","","33.87"
"11/10/2024","","CREDIT","Checking Deposit Overdraft transfer from ****190-S0","","200","","233.87"
"11/10/2024","","DEBIT","Withdrawal  @ AMAZON RETA* N60KQ2 0 AMAZON RETA* N60 WWW.AMAZON.COWA US","-17.38","","","216.49"
"11/11/2024","","DEBIT","Withdrawal  @ AMAZON RETA* LE3RD8 0 AMAZON RETA* LE3 WWW.AMAZON.COWA US","-14.88","","","201.61"
"11/11/2024","","DEBIT","Withdrawal  @ 5810 FOLSOM BLVD 0 CORTI BROTHERS SACRAMENTO CA US","-36.18","","","165.43"
"11/11/2024","","DEBIT","Withdrawal  @ CORTI BROTHERS 0 CORTI BROTHERS SACRAMENTO CA US","-61.5","","","103.93"
"11/12/2024","","DEBIT","Withdrawal  @ BONFARE MARKET #33 0 BONFARE MARKET # SACRAMENTO CA US","-7.47","","","96.46"
"11/12/2024","","CREDIT","Checking Deposit  @ G1 Online Transfer 'STD' 475.00 from share 0","","475","","571.46"
"11/12/2024","","DEBIT","Withdrawal  @ SACRAMENTO NATURAL 0 SACRAMENTO NATUR SACRAMENTO CA US","-32.51","","","538.95"
"11/13/2024","","DEBIT","Withdrawal  @ FD *CA DMV 501 0 FD *CA DMV 501 SACRAMENTO CA US","-382","","","156.95"
"11/13/2024","","DEBIT","Withdrawal  @ FD *CA DMV 501 *SVC 0 FD *CA DMV 501 * 800-777-0133 CA US","-8.03","","","148.92"
"11/13/2024","","DEBIT","Withdrawal  @ LINDA S TAQUERIA 0 LINDA S TAQUERIA SACRAMENTO CA US","-20.82","","","128.1"
"11/13/2024","","DEBIT","Withdrawal  @ SACRAMENTO NATURAL 0 SACRAMENTO NATUR SACRAMENTO CA US","-20.44","","","107.66"
"11/14/2024","","DEBIT","Withdrawal  @ SACRAMENTO NATURAL 0 SACRAMENTO NATUR SACRAMENTO CA US","-22.95","","","84.71"
"11/14/2024","","DEBIT","Withdrawal  @ DALEK ONE* SUBSCR 1 0 DALEK ONE* SUBSC DALEKONE.BANDMN US","-7","","","77.71"
"11/15/2024","","DEBIT","Withdrawal  @ 809 20TH ST 0 BONFARE MARKET # SACRAMENTO CA US","-7.71","","","70"
"11/16/2024","","DEBIT","Withdrawal  @ APPLE CASH SENT MON 0 APPLE CASH SENT 1INFINITELOOPCA US","-10","","","60"
"11/16/2024","","DEBIT","Withdrawal  @ CANVA* I04337-41087 0 CANVA* I04337-41 HTTPSCANVA.CODE US","-15.5","","","44.5"
"11/16/2024","","DEBIT","Withdrawal  @ GITHUB INC. 0 GITHUB INC. HTTPSGITHUB.CCA US","-10","","","34.5"
"11/16/2024","","DEBIT","Withdrawal  @ 5810 FOLSOM BLVD 0 CORTI BROTHERS SACRAMENTO CA US","-15.62","","","18.88"
"11/17/2024","","DEBIT","Withdrawal  @ INSHAPE FAMILY FITN 0 INSHAPE FAMILY F SACRAMENTO CA US","-1","","","17.88"
"11/17/2024","","CREDIT","Checking Deposit  @ G1 Online Transfer 95.00 from LV 1","","95","","112.88"
"11/17/2024","","DEBIT","Withdrawal  @ VENMO *Eva DiGiorg 0 VENMO *Eva DiGi Visa Direct NY US","-53","","","59.88"
"11/17/2024","","DEBIT","Withdrawal  @ PETCO 1343 0 PETCO 1343 SACRAMENTO CA US","-27.71","","","32.17"
"11/17/2024","","DEBIT","Withdrawal  @ VENMO* Marc 0 VENMO* Marc Visa Direct NY US","-31","","","1.17"
"11/20/2024","","CREDIT","Checking Deposit  @ G1 Online Transfer 33.00 from LV 1","","33","","34.17"
"11/20/2024","","CREDIT","Checking Deposit  @ G1 Online Transfer 'STD' 3.00 from share 0","","3","","37.17"
"11/20/2024","","DEBIT","Withdrawal  @ VENMO* Marc 0 VENMO* Marc Visa Direct NY US","-37","","","0.17"
"11/20/2024","","CREDIT","Checking Deposit  @ VENMO*DelFava Marc 0 VENMO*DelFava Ma Visa Direct NY US","","23.58","","23.75"
"11/20/2024","","DEBIT","Withdrawal  @ ATMX031258 2315 J ST CSSI0 EFT Sacramento CA US","-23","","","0.75"
"11/20/2024","","DEBIT","Withdrawal ATM:Fee: ATM FEE DRAFT WITHDRAWAL Trace #73745 2.00","-2","","","-1.25"
"11/20/2024","","CREDIT","ATM FEE DRAFT WITHDRAWAL Trace #73745 1 @ $2.00","","0","","0.0"
"11/22/2024","","CREDIT","Checking Deposit  @ G1 Online Transfer 'STD' 200.00 from share 0","","200","","198.75"
"11/22/2024","","DEBIT","Withdrawal  @ SACRAMENTO NATURAL 0 SACRAMENTO NATUR SACRAMENTO CA US","-5.43","","","193.32"
"11/22/2024","","DEBIT","Withdrawal  @ VENMO *Eva DiGiorg 0 VENMO *Eva DiGi Visa Direct NY US","-20","","","173.32"
"11/22/2024","","DEBIT","Withdrawal  @ 3539 BRADSHAW ROAD 0 FALAFEL CORNER SACRAMENTO CA US","-15.44","","","157.88"
"11/22/2024","","DEBIT","Withdrawal  @ SPLICE.COM* SPLICE 0 SPLICE.COM* SPLI SPLICE.COM NY US","-9.99","","","147.89"
"11/22/2024","","DEBIT","Withdrawal  @ Wikimedia 0 Wikimedia San FranciscoCA US","-3.1","","","144.79"
"11/22/2024","","DEBIT","Withdrawal  @ SQ *PACHAMAMA COFFE 0 SQ *PACHAMAMA CO Sacramento CA US","-5.12","","","139.67"
"11/22/2024","","DEBIT","Withdrawal  @ ATMRT64592 900 MARIN ST CSSI0 PAI ISO SAN FRANCISCOCA US","-43.5","","","96.17"
"11/23/2024","","DEBIT","Withdrawal  @ NETFLIX.COM 0 NETFLIX.COM LOS GATOS CA US","-15.49","","","80.68"
"11/23/2024","","DEBIT","Withdrawal  @ 5810 FOLSOM BLVD 0 CORTI BROTHERS SACRAMENTO CA US","-147.47","","","-66.79"
"11/23/2024","","CREDIT","Checking Deposit Overdraft transfer from ****190-S0","","200","","133.21"
"11/23/2024","","DEBIT","Withdrawal  @ 5810 FOLSOM BLVD 0 CORTI BROTHERS SACRAMENTO CA US","-31.74","","","101.47"
"11/23/2024","","DEBIT","Withdrawal  @ SACRAMENTO NATURAL 0 SACRAMENTO NATUR SACRAMENTO CA US","-20.04","","","81.43"
"11/23/2024","","DEBIT","Withdrawal  @ Spotify USA 0 Spotify USA 877-7781161 NY US","-11.99","","","69.44"
"11/23/2024","","DEBIT","Withdrawal  @ STARBUCKS STORE 056 0 STARBUCKS STORE VACAVILLE CA US","-8.15","","","61.29"
"11/23/2024","","DEBIT","Withdrawal  @ VENMO* Marc 0 VENMO* Marc Visa Direct NY US","-12.27","","","49.02"
"11/23/2024","","DEBIT","Withdrawal ATM:Fee: ATM FEE DRAFT WITHDRAWAL Trace #7839","-2","","","47.02"
"11/23/2024","","CREDIT","ATM FEE DRAFT WITHDRAWAL Trace #7839 1 @ $2.00","","0","","0.0"
"11/23/2024","","DEBIT","Withdrawal  @ ATMX031258 2315 J ST CSSI0 EFT Sacramento CA US","-63","","","-15.98"
"11/23/2024","","CREDIT","Checking Deposit Overdraft transfer from ****190-S0","","200","","184.02"
"11/24/2024","","DEBIT","Withdrawal  @ PADDLE.NET* KAIBER 0 PADDLE.NET* KAIB PADDLE.COM NY US","-15","","","169.02"
"11/24/2024","","DEBIT","Withdrawal  @ 5810 FOLSOM BLVD 0 CORTI BROTHERS SACRAMENTO CA US","-42.63","","","126.39"
"11/24/2024","","DEBIT","Withdrawal  @ PETCO 1343 0 PETCO 1343 SACRAMENTO CA US","-39.11","","","87.28"
"11/24/2024","","DEBIT","Withdrawal ATM:Fee: ATM FEE DRAFT WITHDRAWAL Trace #101973","-2","","","85.28"
"11/24/2024","","CREDIT","ATM FEE DRAFT WITHDRAWAL Trace #101973 1 @ $2.00","","0","","0.0"
"11/24/2024","","DEBIT","Withdrawal  @ FLOWCHART FUN PRO 0 FLOWCHART FUN PR FLOWCHART.FUNNC US","-3","","","82.28"
"11/25/2024","","DEBIT","Withdrawal  @ CREPEVILLE MIDTOWN 0 CREPEVILLE MIDTO SACRAMENTO CA US","-31.24","","","51.04"
"11/25/2024","","DEBIT","Withdrawal  @ CITYOFSAC IPS PKGME 0 CITYOFSAC IPS PK SACRAMENTO CA US","-2","","","49.04"
"11/25/2024","","DEBIT","Withdrawal  @ N STREET CAFE 0 N STREET CAFE SACRAMENTO CA US","-14.98","","","34.06"
"11/26/2024","","DEBIT","Withdrawal  @ AMAZON MKTPL*P27BX7 0 AMAZON MKTPL*P27 Amzn.com/billWA US","-21.94","","","12.12"
"11/26/2024","","CREDIT","Checking Deposit Overdraft transfer from ****190-S0","","200","","212.12"
"11/26/2024","","DEBIT","Withdrawal  @ SACRAMENTO NATURAL 0 SACRAMENTO NATUR SACRAMENTO CA US","-55.65","","","156.47"
"11/26/2024","","DEBIT","Withdrawal  @ SACRAMENTO NATURAL 0 SACRAMENTO NATUR SACRAMENTO CA US","-5.86","","","150.61"
"11/26/2024","","DEBIT","Withdrawal  @ SHANGHAI GARDEN OF 0 SHANGHAI GARDEN SACRAMENTO CA US","-40.41","","","110.2"
"11/27/2024","","DEBIT","Withdrawal  @ APPLE.COM/BILL 0 APPLE.COM/BILL 866-712-7753 CA US","-13.99","","","96.21"
"11/27/2024","","CREDIT","Checking Deposit Overdraft transfer from ****190-S0","","192.92","","289.13"
"11/27/2024","","DEBIT","Withdrawal  @ GOOGLE *CLOUD 9PwCx 0 GOOGLE *CLOUD 9P g.co/HelpPay#CA US","-100","","","189.13"
"11/28/2024","","DEBIT","Withdrawal  @ SHELL SERVICE STATI 0 SHELL SERVICE ST SACRAMENTO CA US","-40.48","","","148.65"
"11/29/2024","","DEBIT","Withdrawal  @ SACRAMENTO NATURAL 0 SACRAMENTO NATUR SACRAMENTO CA US","-43.59","","","105.06"
"11/29/2024","","DEBIT","Withdrawal  @ ATMX031258 2315 J ST CSSI0 EFT Sacramento CA US","-43","","","62.06"
"11/29/2024","","DEBIT","Withdrawal ATM:Fee: ATM FEE DRAFT WITHDRAWAL Trace #48027","-2","","","60.06"
"11/29/2024","","CREDIT","ATM FEE DRAFT WITHDRAWAL Trace #48027 1 @ $2.00","","0","","0.0"
"11/29/2024","","DEBIT","Withdrawal  @ VOCLR.IT 0 VOCLR.IT SALISBURY GB GB","-10.09","","","49.97"
"11/29/2024","","CREDIT","ISA Single-Currency Fee Assessed = 0.10 on 9.99 - Recurring or Installment payment","","0","","0.0"
"11/30/2024","","CREDIT","Checking Deposit  @ GOOGLE *CLOUD 9PwCx 0 GOOGLE *CLOUD 9P g.co/HelpPay#CA US","","100","","149.97"
"11/30/2024","","DEBIT","Withdrawal  @ AMAZON MKTPL*Z35Y17 0 AMAZON MKTPL*Z35 Amzn.com/billWA US","-7.93","","","142.04"
"11/30/2024","","DEBIT","Withdrawal  @ AZUL MEXICAN FOOD & 0 AZUL MEXICAN FOO SACRAMENTO CA US","-28.85","","","113.19"
"11/30/2024","","DEBIT","Withdrawal  @ OPENAI *CHATGPT SUB 0 OPENAI *CHATGPT HTTPSOPENAI.CCA US","-20","","","93.19"
"11/30/2024","","DEBIT","Withdrawal  @ APPLE.COM/BILL 0 APPLE.COM/BILL 866-712-7753 CA US","-12.99","","","80.2"
"11/30/2024","","DEBIT","Withdrawal  @ OPENAI 0 OPENAI HTTPSOPENAI.CCA US","-10","","","70.2"
"11/30/2024","","DEBIT","Withdrawal  @ 5810 FOLSOM BLVD 0 CORTI BROTHERS SACRAMENTO CA US","-33.22","","","36.98"
"12/1/2024","","CREDIT","Checking Deposit  @ G1 Online Transfer 90.00 from LV 1","","90","","126.98"
"12/1/2024","","DEBIT","Withdrawal  @ SAFEWAY #2242 0 SAFEWAY #2242 SACRAMENTO CA US","-20.57","","","106.41"
"12/1/2024","","DEBIT","Withdrawal  @ EMBRACE PET INSURAN 0 EMBRACE PET INSU HELLO@EMBRACEOH US","-23.35","","","83.06"
"12/1/2024","","DEBIT","Withdrawal  @ SOUNDCLOUD INC 0 SOUNDCLOUD INC 176-3257837 NY US","-16","","","67.06"
"12/1/2024","","DEBIT","Withdrawal  @ 2505 Riverside Blvd 0 TARGET T-0310 Sacramento CA US","-35","","","32.06"
"12/1/2024","","DEBIT","Withdrawal  @ SACRAMENTO NATURAL 0 SACRAMENTO NATUR SACRAMENTO CA US","-13.1","","","18.96"
"12/2/2024","","DEBIT","Withdrawal  @ OPENAI 0 OPENAI HTTPSOPENAI.CCA US","-6","","","12.96"
"12/2/2024","","DEBIT","Withdrawal-ACH-A-1096016 ATT (Payment)","-84.99","","","-72.03"
"12/2/2024","","CREDIT","Checking Deposit Overdraft transfer from ****190-S0","","0.01","","-72.02"
"12/2/2024","","DEBIT","Withdrawal COURTESY PAY FEE 20.00","-20","","","-92.02"
"12/2/2024","","CREDIT","A Courtesy Payment was made for the amount of 75.01.","","0","","0.0"
"12/3/2024","","DEBIT","Withdrawal  @ APPLE.COM/BILL 0 APPLE.COM/BILL 866-712-7753 CA US","-2.99","","","-95.01"
"12/3/2024","","CREDIT","A Courtesy Payment was made for the amount of 2.99.","","0","","0.0"
"12/5/2024","","DEBIT","Withdrawal-ACH-A-861479 GEICO (PREM COLL)","-56.55","","","-151.56"
"12/5/2024","","DEBIT","Withdrawal COURTESY PAY FEE 20.00","-20","","","-171.56"
"12/5/2024","","CREDIT","A Courtesy Payment was made for the amount of 56.55.","","0","","0.0"
"12/6/2024","","CREDIT","Checking Deposit  @ G1 Online Transfer 'STD' 200.00 from share 0","","200","","28.44"
"12/6/2024","","DEBIT","Withdrawal  @ VENMO *None 0 VENMO *None Visa Direct NY US","-20","","","8.44"
"12/6/2024","","CREDIT","Checking Deposit Overdraft transfer from ****190-S0","","200","","208.44"
"12/6/2024","","DEBIT","Withdrawal  @ N STREET CAFE 0 N STREET CAFE SACRAMENTO CA US","-16.16","","","192.28"
"12/6/2024","","DEBIT","Withdrawal  @ Amazon web services 0 Amazon web servi aws.amazon.coWA US","-3.6","","","188.68"
"12/6/2024","","DEBIT","Withdrawal  @ AMAZON RETA* ZL5YB2 0 AMAZON RETA* ZL5 WWW.AMAZON.COWA US","-44.38","","","144.3"
"12/6/2024","","DEBIT","Withdrawal  @ SACRAMENTO NATURAL 0 SACRAMENTO NATUR SACRAMENTO CA US","-100.93","","","43.37"
"12/6/2024","","CREDIT","Checking Deposit Overdraft transfer from ****190-S0","","200","","243.37"
"12/6/2024","","DEBIT","Withdrawal  @ ATMX031258 2315 J ST CSSI0 EFT Sacramento CA US","-43","","","200.37"
"12/6/2024","","DEBIT","Withdrawal ATM:Fee: ATM FEE DRAFT WITHDRAWAL Trace #102062","-2","","","198.37"
"12/6/2024","","CREDIT","ATM FEE DRAFT WITHDRAWAL Trace #102062 1 @ $2.00","","0","","0.0"
"12/7/2024","","DEBIT","Withdrawal  @ LALAL.AI 0 LALAL.AI ZUG CH CH","-10.1","","","188.27"
"12/7/2024","","CREDIT","ISA Single-Currency Fee Assessed = 0.10 on 10.00 - Recurring or Installment payment","","0","","0.0"
"12/7/2024","","DEBIT","Withdrawal  @ AFFIRM.COM PAYMENTS 0 AFFIRM.COM PAYME AFFIRM.COM CA US","-46.22","","","142.05"
"12/7/2024","","DEBIT","Withdrawal  @ 5810 FOLSOM BLVD 0 CORTI BROTHERS SACRAMENTO CA US","-123.45","","","18.6"
"12/7/2024","","CREDIT","Checking Deposit Overdraft transfer from ****190-S0","","200","","218.6"
"12/7/2024","","DEBIT","Withdrawal  @ INSHAPE FAMILY FITN 0 INSHAPE FAMILY F 916-987-2030 CA US","-91.99","","","126.61"
"12/7/2024","","DEBIT","Withdrawal  @ AMAZON RETA* ZR2V34 0 AMAZON RETA* ZR2 WWW.AMAZON.COWA US","-67.87","","","58.74"
"12/8/2024","","DEBIT","Withdrawal  @ AMAZON MKTPL*ZR60M0 0 AMAZON MKTPL*ZR6 Amzn.com/billWA US","-5.97","","","52.77"
"12/8/2024","","DEBIT","Withdrawal  @ SACRAMENTO NATURAL 0 SACRAMENTO NATUR SACRAMENTO CA US","-52.3","","","0.47"
"12/8/2024","","CREDIT","Checking Deposit Overdraft transfer from ****190-S0","","200","","200.47"
"12/9/2024","","CREDIT","Checking Deposit  @ VENMO *None 0 VENMO *None New York CityNY US","","20","","220.47"
"12/9/2024","","DEBIT","Withdrawal-ACH-A-1064712 WEBSMUD (WEB PAY)","-75.68","","","144.79"
"12/9/2024","","DEBIT","Withdrawal-ACH-A-983291 WEBADVS ED SERV WEB (STUDNTLOAN)","-151.08","","","-6.29"
"12/9/2024","","CREDIT","Checking Deposit Overdraft transfer from ****190-S0","","177.91","","171.62"
"12/9/2024","","DEBIT","Withdrawal  @ AZUL MEXICAN FOOD & 0 AZUL MEXICAN FOO SACRAMENTO CA US","-6.52","","","165.1"
"12/9/2024","","DEBIT","Withdrawal  @ CHITAS TAQUERIA (Q 0 CHITAS TAQUERIA 165-06819470 CA US","-10.38","","","154.72"
"12/9/2024","","DEBIT","Withdrawal  @ SACRAMENTO NATURAL 0 SACRAMENTO NATUR SACRAMENTO CA US","-8.08","","","146.64"
"12/9/2024","","DEBIT","Withdrawal  @ ATMX031258 2315 J ST CSSI0 EFT Sacramento CA US","-23","","","123.64"
"12/10/2024","","DEBIT","Withdrawal  @ INSHAPE FAMILY FITN 0 INSHAPE FAMILY F SACRAMENTO CA US","-9.99","","","113.65"
"12/10/2024","","DEBIT","Withdrawal  @ VENMO* Marc 0 VENMO* Marc Visa Direct NY US","-112","","","1.65"
"12/10/2024","","DEBIT","Withdrawal ATM:Fee: ATM FEE DRAFT WITHDRAWAL Trace #69572 2.00","-2","","","-0.35"
"12/10/2024","","CREDIT","ATM FEE DRAFT WITHDRAWAL Trace #69572 1 @ $2.00","","0","","0.0"
"12/12/2024","","CREDIT","Checking Deposit  @ G1 Online Transfer 'STD' 150.00 from share 0","","150","","149.65"
"12/12/2024","","DEBIT","Withdrawal  @ VENMO* Marc 0 VENMO* Marc Visa Direct NY US","-149","","","0.65"
